player,mu,sigma,wins,losses,sets
bluntsmokinganusdestroyer,9.99158375206,4.10337376486,0,10,10
hwats,9.93561357389,3.55878328386,0,12,12
fog man,9.90398238627,3.44518099541,0,9,9
yung duccboii,9.8766333185,3.96494837137,0,7,7
sucksatgames,9.86696466355,3.88217523291,0,6,6
seaniemaster,9.64932681262,3.79889134545,0,8,8
big sippy,9.60137804042,3.49529409118,0,10,10
oquinn,9.57703748332,3.16424023858,1,11,12
macrado,9.52464402456,3.40779924102,0,13,13
gluu,9.46116648565,3.8871137259,0,6,6
jet fuel,9.33162436609,2.90104394764,1,16,17
soggy biscuit,9.19359153653,3.40004978391,0,9,9
zoom,9.17595106859,3.50459512486,0,9,9
seaweed dragon,8.99955206549,3.70655138023,0,8,8
golfclubninja,8.65839476789,2.81333513662,1,28,29
shunkun,8.55795737172,3.2666872545,0,16,16
archduke,7.49092179152,3.60716113446,0,9,9
superboomfan,51.5696175632,1.18296672933,214,11,225
alvin,49.0662944338,1.20320128926,87,11,98
fukurou,48.7518558652,1.57791894719,42,4,46
wizzrobe,46.2147275162,1.07370858319,113,25,138
kysk,46.1834024808,2.04114257253,18,4,22
kurabba,46.0643073451,1.9312841347,20,4,24
wario,46.043499319,2.28842401115,18,3,21
mariguas,46.0145534611,1.07933087222,112,24,136
wangera,45.3466539967,1.69780648394,29,7,36
gerson,45.3331158881,3.02427092325,10,0,10
kerokeroppi,45.1129376686,1.10575168209,83,23,106
dext3r,45.0228399607,1.15280248271,77,20,97
isai,44.7139889071,1.26247067551,68,15,83
tacos,44.2174201477,1.19894123802,80,21,101
zero,44.084435853,1.10943576252,92,22,114
fox,43.4731676786,1.29683129704,56,12,68
prince,43.4357153866,2.15449058824,17,4,21
revan,43.0542922896,1.08364032286,79,25,104
joshi,42.8580461102,1.84384255762,21,5,26
sultan,42.4771305981,3.03848180018,10,1,11
lowww,42.2552882248,1.3529518473,53,11,64
josh brody,42.0840510326,0.926796043311,211,68,279
gyaki,41.9621992827,2.64030893353,11,2,13
yu-kun,41.6824036955,3.05267095589,5,2,7
hiyo,41.6306982262,2.69761834134,9,2,11
tr3gthez,41.6277373637,1.12794515459,67,24,91
cali64nia,41.55749491,2.81595784442,10,2,12
taimai,41.2282521527,2.99858535049,5,2,7
stranded,40.8688939155,1.2141066933,63,19,82
tavomono,40.62521702,2.56455746452,9,3,12
kort,40.1698505746,1.2218191723,47,21,68
lord narwhal,40.1532371917,1.18187345851,60,20,80
jaimehr,40.0276502277,1.20465378794,56,23,79
robert,40.0213183811,1.31136305605,44,15,59
hero pie,39.9192295091,1.66085500438,31,9,40
dtan,39.8141079875,1.6122126811,24,10,34
firo,39.6797344408,1.46211887578,35,14,49
derek,39.5484050837,1.68737317488,16,10,26
cobr,39.5368180147,1.19118987139,58,21,79
hammerheart,39.1128697437,1.25816886457,55,18,73
shalaka,39.017253641,1.6687134865,27,11,38
ctg,38.9570498883,0.973531982858,104,39,143
sheermadness,38.6284847481,2.05112840838,16,6,22
czar,38.5930046088,1.68391242138,28,9,37
banze,38.573961212,2.45429791917,11,5,16
ybombb,38.5625924071,1.40609090679,34,15,49
heropie,38.4417733464,1.87982443112,20,7,27
kd3,38.3793623576,1.05821816829,83,27,110
star king,38.0215182419,1.25787307732,50,20,70
handsometom,37.7323939812,2.0302676125,14,8,22
clubbadubba,37.6372309276,1.56694054906,30,12,42
kimimaru,37.6296701373,1.55732115017,29,14,43
fancey,37.6273777708,2.92655060324,8,3,11
nacl,37.5778466258,1.15166160243,52,25,77
manjaro,37.5758700971,3.14763898778,8,3,11
cesar,37.516384097,2.86575758831,7,3,10
bonobono,37.1076432096,3.30573862343,5,2,7
combo blaze,36.9229782253,1.40350542407,43,18,61
nta,36.790926682,1.733912535,23,10,33
janitor,36.7389309526,1.30428427658,51,21,72
fireblaster,36.6640688669,0.895321711463,146,64,210
yellowbob0,36.5650363651,3.08786334791,9,2,11
kyle tree,36.4747032705,1.91457862315,18,10,28
marbles,36.310979181,1.15799756501,56,24,80
loto,36.2600824151,1.24059808728,42,21,63
greginator,36.2004015538,3.47139284995,4,2,6
skg,36.1153973059,1.27665046601,36,18,54
finio,36.0601967722,1.24426769255,44,21,65
stevie g,36.0300178062,1.36085980116,40,14,54
shears,35.9933624361,0.899320094896,158,74,232
nintendude,35.8251213627,1.19717401291,53,29,82
yunque,35.8204496127,1.46892149993,31,15,46
horbie,35.7915737917,1.11923862743,68,32,100
sotoh,35.7541524467,1.31906183766,42,21,63
janco,35.7212204828,1.28798165099,31,24,55
eg,35.7035386374,1.1862917011,45,22,67
roman,35.4781989621,1.51208965166,34,16,50
jason,35.399465096,1.23889569818,40,21,61
hydra,35.3129293999,1.70476654419,23,11,34
lorenzo,35.2395952938,1.64935232541,24,11,35
darkhorse,35.1910597399,0.924332565115,113,63,176
fumbles,35.0539771382,1.81158360851,20,8,28
antwon420,35.0402079717,1.98847561578,15,7,22
nothing,35.0178450691,2.24135050833,14,6,20
purple circle,34.8264529356,2.8383071529,12,4,16
blondekid,34.8140261594,1.71780592765,22,11,33
bloodpeach,34.800150232,1.82603879728,20,9,29
mohinder,34.7806044111,2.28105986133,10,6,16
jose,34.7671925609,2.59130711347,8,4,12
amida,34.6833714129,2.269405235,12,7,19
hotline,34.6544278607,1.66300546444,21,11,32
$$$ jim $$$,34.629318285,1.44769461364,32,16,48
vinsanity,34.5688007854,1.87039393329,16,8,24
daniel,34.4434945444,1.63060754914,21,14,35
letsgo,34.4182657945,1.82868871198,19,12,31
jam,34.3603828593,2.59395054839,8,5,13
dark gentleman,34.3392802793,1.16701614715,50,26,76
supa,34.3336979325,1.60305546636,22,13,35
gilkaoz,34.2864820039,3.27656609904,6,4,10
wez,34.2100625362,3.55649626669,5,3,8
gravyfingers,34.0919320217,2.04928570444,17,8,25
yobo,34.0654406448,1.12635225054,54,32,86
timemachine,34.0311585603,1.38658366577,34,18,52
schickler,33.9273152547,2.64494193496,9,4,13
freean,33.8995900554,1.23490391154,48,24,72
connor,33.8923035218,1.93166589581,20,10,30
the ki of chaos,33.8634222584,5.8909953882,1,0,1
hipstur,33.8528495733,1.16265088012,61,27,88
wookiee,33.8292416541,1.27463614466,44,23,67
madrush,33.7776408383,0.957408579013,82,59,141
preston,33.7401840483,1.08635442694,56,36,92
cover,33.6939265898,3.25841225051,5,4,9
james3927,33.6260925009,2.52524045934,11,4,15
masterhandjob,33.5306745589,1.11250071586,54,30,84
time machine,33.4296114759,1.85088343502,19,10,29
b link,33.4210302855,3.4233122782,4,3,7
pugs,33.3509738322,1.26066899614,35,24,59
satan [turner],33.3259905133,3.29674907612,4,3,7
butt solo,33.322156546,3.84786629991,3,3,6
shihman,33.2747828704,1.20973332349,51,28,79
fishaman p,33.272616427,2.40062041234,9,6,15
raychu,33.2692259218,1.24330939046,47,22,69
dajjal,33.2521262185,1.71389874541,22,13,35
fruity,33.2399161756,3.52369954465,5,2,7
facechew,33.1235160338,3.94508944253,5,2,7
near,33.1197859476,1.66525144816,23,12,35
sedda,33.0170694117,1.35578137824,36,20,56
sextc,32.9715959089,1.55447854777,23,18,41
sax,32.9608465022,2.20399716315,12,7,19
zeppelin,32.9315705413,3.10089909277,5,3,8
indefa,32.9187777021,1.92951025168,19,9,28
monte,32.9113606792,1.92131162462,15,6,21
smash jesus,32.905929071,2.29307660496,14,6,20
bo,32.8900892404,2.00231463171,14,9,23
snorlax,32.8763920404,1.50201505962,25,16,41
the protagonist,32.8013349101,1.16441597502,50,32,82
sunnyb,32.7730670611,3.5395614178,4,3,7
nickelbackstreetboy,32.7316089371,3.52248389185,4,2,6
fray,32.6964297771,2.05708343457,6,9,15
dogs_johnson,32.6927582274,1.19165764258,48,28,76
mr.sir,32.6742357326,1.10945356797,55,35,90
mojomonkey,32.6643716155,2.2010445146,12,7,19
dr. grin,32.6549562517,1.88683059578,17,12,29
cyoonit,32.5929864271,1.87008347741,14,10,24
j.moosh,32.5258628495,2.8033679558,9,4,13
poobearninja,32.4037778794,2.84303906931,9,4,13
jay_mute$,32.3995065607,1.67488605254,20,12,32
stonefallow,32.392499565,3.49415537303,6,4,10
tictactactic,32.346702612,3.83424124403,5,2,7
dishier wand,32.3039710953,1.3887246068,31,23,54
gildo,32.2702735243,1.55409431026,27,14,41
bard,32.2313015238,1.18411772792,43,31,74
andykins,32.2270151288,1.29369843693,40,19,59
th3kuzinator,32.201888485,3.336727397,6,4,10
subtle,32.1400199333,2.33573090334,13,9,22
the dark gentleman,32.0509317121,3.552146823,4,3,7
eggmode,31.9837689857,2.09828212766,13,11,24
b0n,31.9822767556,3.9641478883,4,2,6
jay-r,31.9699538191,1.52823758312,26,15,41
weedwack,31.9604578471,1.56908264472,21,17,38
limesoda,31.9373243475,1.31332797424,42,19,61
dogg,31.9213428781,2.58691293485,8,6,14
knitephox,31.9139398066,2.41934327807,10,7,17
hippo,31.8418294125,3.58040394194,4,4,8
ken,31.7996316097,5.4069569839,2,1,3
spongy,31.7965667272,1.25572243442,39,22,61
elel,31.7909981838,1.54076181937,28,18,46
tank,31.6702340144,2.48646737285,10,7,17
spark,31.655875356,2.75560277708,7,4,11
qapples,31.637642519,1.32862202613,32,26,58
battlecow,31.6292306308,3.39844264696,4,3,7
socrates,31.5754127319,2.51028659997,7,6,13
d35,31.5589821659,1.50196829749,26,18,44
nyx,31.5505454367,2.15185631734,15,7,22
nattybroh,31.5369189623,2.65377269796,9,4,13
kirbstomper,31.5188344006,3.86445858352,4,3,7
moosh_da_moosh,31.517374649,2.09319149394,14,8,22
b33f,31.3786929139,1.24579105099,38,24,62
newbtube,31.311410724,2.24685389922,11,7,18
q!,31.2917811305,1.28433369245,38,28,66
deathcpo,31.2563857349,1.24689139235,37,28,65
dr. lampy,31.2346140702,1.61974648816,18,12,30
paco,31.234516851,1.25572086086,40,28,68
commander,31.219157037,4.42278572814,3,2,5
josephzander,31.1970589582,3.43151938178,5,3,8
a to the z,31.1815175432,2.11111537208,11,10,21
rossi,31.1312028168,4.20548682927,3,2,5
pete,31.0990824104,3.62685915722,4,3,7
saltsizzle,31.0924201,1.73863374869,17,13,30
tyhiggz,31.0587119119,1.18520642728,43,30,73
kaz,30.9770413149,1.15495084734,51,31,82
studstill,30.9536732493,3.00999311985,7,4,11
jimmy joe,30.8947709298,1.08063760115,46,45,91
onski,30.8896570955,1.2937210569,36,29,65
ivor,30.8866197892,4.09947611008,3,2,5
shanks,30.8194751997,2.93699975917,6,5,11
gunnermaniac,30.7946276507,1.97507404255,12,10,22
repsguy,30.7914931187,5.04039718708,1,1,2
borlin morlan,30.7892617194,4.17308790286,4,2,6
a$,30.784148027,2.3595169587,10,6,16
se√±orhen10r,30.7521299023,3.45397070328,4,3,7
miniohh!,30.7495327631,1.64639691004,20,13,33
tot,30.6935093983,3.09561865676,7,6,13
therm,30.6581829237,3.99350991501,4,2,6
rusty,30.6552533613,1.22832988772,34,28,62
fck vwls,30.603307738,1.54665673022,20,21,41
dubs,30.5848088535,3.18209149888,7,4,11
joker,30.5214195058,4.04587259583,2,3,5
zeozen,30.5151944656,3.97417476235,4,3,7
komotonoto,30.5050126997,1.9936284686,14,9,23
snowstorm,30.5037431917,2.26416883039,15,7,22
jamjar,30.4975715551,1.08841960252,53,43,96
bowl,30.4591852006,1.63959211669,19,17,36
scoback,30.4559235729,2.44904976937,9,9,18
g0d,30.4520395022,4.37766960873,2,2,4
skyfire,30.4270278889,1.82796394242,14,12,26
bread,30.4267262647,1.74437203018,17,15,32
natty,30.3786976986,2.78628429876,7,4,11
fancy,30.324929621,4.26621049369,3,2,5
yoleo,30.1996291132,1.59273877571,20,17,37
saintheavens,30.1897749539,3.5091079514,4,4,8
the big d,30.1775938312,1.78501102473,12,15,27
korobeniki,30.16027345,1.27631477707,38,28,66
bon,30.1405212139,2.21178681124,11,12,23
captain l,30.134563456,1.89520490192,14,15,29
the (.)(.),30.1313243789,2.39389781566,9,7,16
pizza jokes,30.1150890639,3.52438013142,3,3,6
lob,30.1148298243,1.904477271,16,10,26
american patriot,30.1094031528,1.80580727859,18,8,26
captain fabulous,30.0972145705,1.45464157598,27,21,48
llcstoism,30.094437659,1.7305247759,17,15,32
emptyw,30.0522881952,2.6740988493,8,5,13
rith,30.0135657531,3.90958200199,3,3,6
wincancel,30.0087230808,1.90997779824,19,10,29
üö®üö®üö® wee woo wee woo wee woo üö®üö®üö® you are being detained üëÆüèªüëÆüèªüëÆüèª for being awake during real falco hours üïêüëåüèªüòè please show me your real falco registration üôèüèªüìù by smashing the mothafuccin b button,29.9609131121,4.19505800663,4,2,6
mokkori,29.9221620874,4.18659466566,3,2,5
bt,29.8630648507,2.16935930015,9,8,17
moogle,29.8328805413,4.33168728203,3,2,5
heny935,29.7696187908,3.94753657778,4,2,6
v,29.7208665999,1.3707577211,29,25,54
daniels,29.714464096,1.47003180655,27,20,47
olbus,29.7133284505,3.95724362534,4,2,6
razz,29.6876281505,1.04410363889,61,46,107
crockett,29.6856743205,2.44470592665,8,6,14
spamus,29.6614839882,1.30714966189,30,28,58
mr. wang,29.6048887164,4.10245695982,4,2,6
reptar,29.5803774817,1.29800952929,34,27,61
bert,29.5643139333,4.0080990431,4,3,7
pewpewu,29.5145792011,3.04399514384,8,5,13
umbra,29.4752212703,3.27260665752,6,4,10
quitrage,29.4726817321,3.26070314599,5,4,9
zuber,29.4669562276,3.49261319552,3,5,8
craigpwners,29.4531625247,2.60689431073,8,5,13
piratetrips,29.4424276796,2.8106095419,7,4,11
sheick,29.4387742063,3.12515347161,6,5,11
the american patriot,29.4373245494,4.21048447834,4,2,6
rocket,29.4329676068,1.33816624159,28,25,53
greeno,29.4211172998,1.66003619661,23,15,38
dublat,29.39583202,7.17147558733,1,0,1
stingers,29.39583202,7.17147558733,1,0,1
blue,29.39583202,7.17147558733,1,0,1
sarge,29.39583202,7.17147558733,1,0,1
charky,29.39583202,7.17147558733,1,0,1
sampai,29.39583202,7.17147558733,1,0,1
jxc,29.3863335079,2.11644852086,11,8,19
logic,29.3526158181,2.09919634472,10,8,18
0prah,29.3294654286,2.85506269652,6,6,12
natendo,29.2949841333,2.06152864557,12,8,20
t-beau,29.2695702553,2.79046895444,7,6,13
reefybeefy,29.2272761659,1.83297170656,14,13,27
thord's bro,29.2261123539,3.15560947586,5,4,9
morino,29.2260895886,3.85461294267,3,3,6
dizzle,29.200991274,1.37597377508,26,27,53
mustard tiger,29.0995072215,3.32198432043,6,4,10
aerosheep,29.0784693933,3.97219214182,4,3,7
kriskringle,29.0456483278,2.22683373221,10,7,17
toro,29.0095603006,4.38928209674,3,2,5
touque,29.0091436102,4.27614569944,3,2,5
dboss,29.0034475013,2.60062612099,7,5,12
duffman,28.9980001231,4.44960530657,3,2,5
white,28.9872424465,2.1408746653,15,9,24
chet dunskies,28.9779150464,3.43230975731,5,3,8
mando,28.964963299,1.82010162259,16,15,31
king lumsy,28.9124058098,2.6557649444,7,6,13
nesskhalifa,28.9117513391,1.59977748336,20,19,39
fil,28.9112003571,1.37123355004,26,28,54
yrn,28.8874252081,2.26153582164,8,8,16
allgreen,28.8794547586,2.44454303813,7,6,13
backes,28.8380720539,4.50152235492,2,3,5
annex,28.8321583314,1.52915246055,26,20,46
gt,28.7904784366,0.921105128808,92,84,176
pathall,28.7490720001,4.69490937675,2,2,4
velocity jones,28.7390394636,1.06181970215,57,47,104
bamster,28.6263457842,3.4607947188,5,4,9
a la carte,28.6155693035,3.55567576317,5,4,9
kelvinheit,28.5958189921,1.43620511457,29,19,48
fenlet,28.5921538755,4.7415066217,2,2,4
breakthrough,28.5479065239,1.94594933991,13,14,27
birdlordmasterbeak,28.5429251864,7.1211258753,1,0,1
broly,28.5095943945,2.3348585072,11,7,18
cam,28.4974237327,1.97921786344,10,12,22
zuko,28.4806209858,1.94033365637,16,14,30
purtle,28.4263423209,1.96049343302,12,12,24
slappypoopy,28.3794456587,1.59076739637,22,18,40
smurf,28.3422430039,1.0679241052,61,50,111
phut,28.3223415456,3.99197197983,3,3,6
tvdonk,28.3203937299,4.45958674045,3,2,5
ibc,28.3130419186,3.36281447405,4,4,8
coin chaser,28.2990279648,4.40912520839,3,2,5
fenrir,28.2659219659,4.67173243359,2,2,4
tonester,28.2516370753,2.04886078396,14,10,24
bloogo,28.2331762603,1.14728627562,39,37,76
blaise,28.2055181803,4.52219949795,3,2,5
peasantloaf,28.1958652619,4.26248928484,3,2,5
jsmirk,28.1786773132,1.51164012475,26,22,48
bacorn,28.1547985168,2.47680002995,9,9,18
autobaun,28.1529055021,4.53845634446,3,2,5
nattyb,28.1340321176,4.41412338,3,2,5
cody,28.1317835422,4.80621821526,3,2,5
toronto joe,28.0996945701,4.53051547838,3,2,5
batterybird,28.0646892936,4.53376969681,3,2,5
epic!,28.0305831624,2.98752907911,6,4,10
professor_wizard,28.0210942536,1.44294944671,29,22,51
kraines,28.0154055579,4.8746850721,3,1,4
maps,28.0019121119,1.39737578071,26,23,49
ringedge,27.9818492395,1.39664346755,25,22,47
darkneon,27.9791748946,2.52155167141,9,6,15
sebula4,27.9711233548,4.45140829467,3,2,5
mr. slimey,27.9009177151,4.73772364665,2,2,4
box765,27.8983751029,1.38326876902,21,25,46
anotherish,27.8482318501,4.74516644549,3,2,5
fake,27.8304588719,3.24590055844,4,4,8
enneielle,27.8195884603,3.84402021199,3,3,6
taiko,27.79669463,2.48691286077,8,9,17
waxy:joe,27.7774996636,1.33851470288,24,25,49
dragoniota,27.7660977373,4.48734501111,3,2,5
xor,27.7306959177,4.55622523955,3,2,5
automatic,27.7235451899,1.63824086772,16,19,35
maliki,27.703297336,2.08341757887,13,11,24
zyrg,27.6835978768,3.14519501908,5,4,9
xyk,27.6764184763,4.4512066855,4,2,6
hack,27.6702144157,1.66634602014,19,17,36
rishi,27.647708981,5.64887358,2,2,4
kabal,27.625076721,3.87756274923,4,3,7
rizner,27.5775189215,1.7636922578,18,16,34
marlwolfe,27.552619447,3.82671112369,3,3,6
quickcav,27.5443756242,3.2565030456,5,3,8
t0mmii,27.5268971516,4.50511998972,3,2,5
duff man,27.5099552824,1.92010527332,12,14,26
maniac379,27.497186393,1.3162908397,31,33,64
viberant,27.4801107959,2.45536752532,8,7,15
bigfish,27.4426678931,1.94185712674,15,11,26
kelpsicle,27.4042862287,4.26894308345,3,3,6
darv,27.3997693731,2.29628612802,9,10,19
my buddy mike,27.3726033631,5.18401276847,2,2,4
toa,27.3079268607,5.42871482802,2,2,4
beans,27.2945113175,1.70995394398,18,15,33
dpb,27.2936032517,4.60076381324,3,2,5
ern,27.2752491302,4.52152801546,3,2,5
1000,27.2336915033,5.26256748611,2,2,4
zackerz,27.1824714934,2.8537038581,7,5,12
maze,27.158776673,4.91665644948,2,2,4
p21/c,27.1562891624,1.87773030345,13,15,28
r6=s2=(sr)2=1>,27.1273529815,3.78303354084,3,2,5
okuser,27.1152519117,2.21242684774,8,10,18
vanillarin,27.0980936505,3.11266416706,6,6,12
pizza,27.0958435597,1.52010581717,23,25,48
dam_tewton,27.0874009668,2.31912096723,9,10,19
meromorph,27.0813210303,5.02092214051,2,2,4
inukem,27.0562404083,2.79631224836,4,6,10
freddy cougar,27.0208363255,5.4314485912,2,2,4
vudujin,26.9460054325,4.79897904172,2,2,4
jnatty,26.9385081304,3.09743517806,6,6,12
kyle,26.9264095943,1.9355106025,13,11,24
sunflower,26.9189834483,1.38017325996,25,28,53
the yid,26.8821187721,1.14817174604,42,45,87
cam2,26.8473479527,2.34292116661,7,8,15
vanddar,26.812335727,4.90847115312,2,2,4
kaladin,26.7588062893,4.84757461904,2,2,4
m-angry,26.7549518461,2.12096737654,11,9,20
flanders,26.732648174,2.78667124748,7,5,12
big dick damage,26.7256166474,3.23618847296,4,4,8
shake,26.7163623337,2.54053857145,7,9,16
walkrofsky,26.7126858727,1.75958466741,12,17,29
blue lantern,26.7089583799,4.91653030037,2,2,4
pintoa,26.7074321115,1.86754404697,18,12,30
fudgeball,26.6898458363,4.16016709503,2,2,4
abszero,26.6766861614,4.21915893279,3,3,6
shyboy,26.6343030405,4.82060840724,2,2,4
sav,26.6156149409,2.34346394536,8,7,15
el man,26.5881263701,2.59749175028,7,5,12
hoofy,26.5837344949,1.59684903387,22,20,42
synth,26.578067152,4.42366478021,2,2,4
cwic-beam,26.5734889621,1.91787287126,14,14,28
salami,26.570096146,3.05739829309,6,5,11
mr.watchandlearn,26.5228195193,4.95596810829,2,2,4
oh thomas,26.4681284015,4.31076383731,3,3,6
dad,26.4558691109,2.8928727523,7,5,12
whitejesus,26.4384135961,1.23305921929,30,36,66
nalgas,26.4324148357,4.52154689818,3,2,5
clumsy,26.4231521057,5.24172278006,2,2,4
beavith,26.4069388381,2.78333496569,6,4,10
ham,26.3935058418,1.55086737056,20,22,42
killahertz,26.3850730511,3.04266130492,5,6,11
k rool,26.3816197929,1.42607496978,26,26,52
gooby,26.3364191184,2.78086011845,6,7,13
stonehaus,26.3144683052,4.85649340991,3,2,5
thomdore,26.285996667,5.07756869741,2,2,4
kirbyrocket,26.2696535538,4.29315540544,3,2,5
cam1,26.1997056424,2.51921030394,8,7,15
hhhhhhhhhhhhhhh,26.1805605948,4.94442759964,2,2,4
king funk,26.1514296284,4.12026214042,2,3,5
stew,26.1411545047,1.30405252015,32,34,66
hypa,26.1258403992,4.79492866376,2,2,4
droc,26.0862263061,1.36903382641,24,29,53
shishkabobs5,26.0718708003,5.37780397789,2,2,4
flatvi,26.0316620538,4.22518535009,3,3,6
toxic,25.9748928917,1.8913912951,13,11,24
boomalready1,25.9453830841,3.75152378119,3,4,7
bringdaruckus312,25.8961482234,4.91181907561,2,2,4
bunz,25.8918599542,2.19208887064,11,15,26
mortech,25.8725559056,1.68411713877,17,19,36
bigbeaver,25.8354525613,1.30558621114,26,34,60
cmull,25.8138359364,3.45247071181,3,4,7
collin,25.796194034,2.28114891406,9,9,18
lordtoko,25.7204410211,1.89856558017,13,12,25
hoofydough,25.7113062928,4.91600928402,2,2,4
traiman,25.6758467053,1.9624084054,11,14,25
baby legs,25.6670266775,2.56260652605,7,7,14
lookalike,25.6392861845,3.68293491127,4,4,8
ace,25.6293038454,1.60175681831,16,21,37
webwipe,25.6205482623,3.38403608918,3,4,7
scratch,25.6080295772,1.86914583635,13,16,29
z-rex,25.5955181592,2.71121088062,5,8,13
meerkat,25.5878213051,2.38834123208,9,10,19
komodoninja,25.5751877139,2.70098570682,8,5,13
tbq,25.5735554737,3.35661932001,4,4,8
bovine,25.5712298409,3.10973724689,5,5,10
j9d2,25.5678331018,4.26488499498,2,2,4
sebula,25.5667387584,1.26174012866,29,35,64
chuck lubs,25.5606773425,5.02116683742,2,2,4
blmb,25.5520885702,4.74303797142,2,2,4
prime,25.5398131171,1.67264388323,17,17,34
hariballz,25.5354729254,3.41739874239,4,4,8
funkykong,25.5050742126,4.87107097566,2,2,4
slappymcnutz,25.4868904006,1.91508615607,10,16,26
dingo boy,25.4752119328,4.29241790974,3,3,6
ttt,25.4666056223,3.01512286713,3,6,9
justin,25.4506652964,2.69369750463,7,6,13
mixxedvegetables,25.4501743805,4.70204997659,2,2,4
t brett,25.3672268045,3.85885606305,3,4,7
griffith,25.3652873605,1.3843672956,22,28,50
starchild,25.3611312572,2.95232769534,6,6,12
nasian,25.3404237394,5.74907458247,1,1,2
therapture_,25.3258278266,5.13054155253,2,2,4
sunvulcan,25.3099668423,1.54535832479,21,19,40
salt,25.2941591503,4.96321040971,2,2,4
purple fox,25.2890644797,4.58709452422,2,2,4
wazzberry,25.2821512309,4.73421942984,2,2,4
cortese187,25.2734327832,4.80713072026,2,2,4
log,25.2660483396,2.95114276916,4,6,10
swiftbass,25.2622368269,4.89216411198,2,2,4
zhu,25.2570917719,5.15198224649,1,2,3
zbl_mystic,25.2552120698,5.229602591,1,2,3
moju,25.2541525953,5.20046083113,2,2,4
sj ryker,25.2541525953,5.20046083113,2,2,4
klms,25.2540556461,4.9265753216,2,2,4
pandemonium,25.220578387,4.55214797812,2,2,4
blisstex,25.2197079838,2.96082630719,6,7,13
tbaby,25.1360634728,4.78836323332,2,2,4
doughnut,25.1310076492,4.90251516435,2,2,4
qubit,25.1257493202,4.91426923128,2,2,4
karlthemarx,25.1124033326,4.8206721687,2,2,4
giraphe,25.0914428523,4.84082291314,2,2,4
le_vinny,25.0869309351,2.13530943803,12,11,23
leavescat,25.0864837849,3.53972568507,4,4,8
poptartplug,25.0826285291,5.11818158289,2,2,4
iheartqueso,25.0785758513,2.64812842496,8,9,17
tom bombadil,25.0468821941,3.2776991495,4,5,9
damp,25.0462356422,4.82420329543,2,2,4
measthebeast,25.0443473177,2.09142212862,9,10,19
notlightningrunner,25.0432425227,4.65308130371,2,2,4
dolan,25.018968915,4.94617049301,2,2,4
beguiler,25.0181002617,5.04179208223,2,2,4
donatello,25.0,8.33333333333,0,0,0
adubz,25.0,8.33333333333,0,0,0
refriedjeans,25.0,8.33333333333,0,0,0
[stg] overload,25.0,8.33333333333,0,0,0
benb,25.0,8.33333333333,0,0,0
marfslayer 3000,25.0,8.33333333333,0,0,0
imperium,25.0,8.33333333333,0,0,0
snazzy,25.0,8.33333333333,0,0,0
filet,25.0,8.33333333333,0,0,0
s≈çcrates,25.0,8.33333333333,0,0,0
redeagle2000,25.0,8.33333333333,0,0,0
magitech,25.0,8.33333333333,0,0,0
pastor,25.0,8.33333333333,0,0,0
ubll black mage,25.0,8.33333333333,0,0,0
lunchy,25.0,8.33333333333,0,0,0
flash,25.0,8.33333333333,0,0,0
bus,25.0,8.33333333333,0,0,0
moft,25.0,8.33333333333,0,0,0
dunos_,25.0,8.33333333333,0,0,0
hail_sagan,25.0,8.33333333333,0,0,0
mouse,25.0,8.33333333333,0,0,0
royeric,25.0,8.33333333333,0,0,0
lala,25.0,8.33333333333,0,0,0
drake,25.0,8.33333333333,0,0,0
bulldog,25.0,8.33333333333,0,0,0
sd master,25.0,8.33333333333,0,0,0
djltheescapade,25.0,8.33333333333,0,0,0
jobook,25.0,8.33333333333,0,0,0
monk,25.0,8.33333333333,0,0,0
acestarthe3rd,25.0,8.33333333333,0,0,0
ozymandias,25.0,8.33333333333,0,0,0
astumpycow,25.0,8.33333333333,0,0,0
dude,25.0,8.33333333333,0,0,0
tdx,25.0,8.33333333333,0,0,0
rice,25.0,8.33333333333,0,0,0
mistertizye,25.0,8.33333333333,0,0,0
dfu,25.0,8.33333333333,0,0,0
sheen,25.0,8.33333333333,0,0,0
dobermen?,25.0,8.33333333333,0,0,0
chai,25.0,8.33333333333,0,0,0
sabo,25.0,8.33333333333,0,0,0
brentosfreshness,25.0,8.33333333333,0,0,0
yung,25.0,8.33333333333,0,0,0
cr0ak,25.0,8.33333333333,0,0,0
fireberts,25.0,8.33333333333,0,0,0
ferrero64,25.0,8.33333333333,0,0,0
the cfb,25.0,8.33333333333,0,0,0
malkasaur,25.0,8.33333333333,0,0,0
brendanhall,25.0,8.33333333333,0,0,0
travkid,25.0,8.33333333333,0,0,0
awesomethesauce,25.0,8.33333333333,0,0,0
branchan,25.0,8.33333333333,0,0,0
tarn,25.0,8.33333333333,0,0,0
juno,25.0,8.33333333333,0,0,0
big d [hamiel],25.0,8.33333333333,0,0,0
nokto,25.0,8.33333333333,0,0,0
zb,25.0,8.33333333333,0,0,0
4eyez95,25.0,8.33333333333,0,0,0
foxnard,25.0,8.33333333333,0,0,0
magnus combosen,25.0,8.33333333333,0,0,0
locamash,25.0,8.33333333333,0,0,0
flayer,25.0,8.33333333333,0,0,0
sleeh,25.0,8.33333333333,0,0,0
ajp,25.0,8.33333333333,0,0,0
masterofzoroark,25.0,8.33333333333,0,0,0
birdybirds,25.0,8.33333333333,0,0,0
goomah,25.0,8.33333333333,0,0,0
spicky,25.0,8.33333333333,0,0,0
puddn,25.0,8.33333333333,0,0,0
sharktoast,25.0,8.33333333333,0,0,0
rudedude,25.0,8.33333333333,0,0,0
flat nat,25.0,8.33333333333,0,0,0
name,25.0,8.33333333333,0,0,0
bird-dawg,25.0,8.33333333333,0,0,0
lukem,25.0,8.33333333333,0,0,0
smashlopez64,25.0,8.33333333333,0,0,0
grunyan,25.0,8.33333333333,0,0,0
mimi,25.0,8.33333333333,0,0,0
dr.shots,25.0,8.33333333333,0,0,0
god,25.0,8.33333333333,0,0,0
squallette,25.0,8.33333333333,0,0,0
johnnyfight,25.0,8.33333333333,0,0,0
fruitfly,25.0,8.33333333333,0,0,0
vio,25.0,8.33333333333,0,0,0
k-phat,25.0,8.33333333333,0,0,0
afro,25.0,8.33333333333,0,0,0
xbc30ep450,25.0,8.33333333333,0,0,0
coldo,25.0,8.33333333333,0,0,0
bedgar,25.0,8.33333333333,0,0,0
jeremy,25.0,8.33333333333,0,0,0
ldz,25.0,8.33333333333,0,0,0
oljace,25.0,8.33333333333,0,0,0
stephanie,25.0,8.33333333333,0,0,0
bund,25.0,8.33333333333,0,0,0
purplefox,25.0,8.33333333333,0,0,0
pvc,25.0,8.33333333333,0,0,0
scuttlebug jamboree,25.0,8.33333333333,0,0,0
l0n3r,25.0,8.33333333333,0,0,0
little bill,25.0,8.33333333333,0,0,0
thac0,25.0,8.33333333333,0,0,0
bronze_sun,25.0,8.33333333333,0,0,0
pilot,25.0,8.33333333333,0,0,0
jarl,25.0,8.33333333333,0,0,0
kcon,25.0,8.33333333333,0,0,0
the amazing busterino,25.0,8.33333333333,0,0,0
king lui,25.0,8.33333333333,0,0,0
8am,25.0,8.33333333333,0,0,0
reb,25.0,8.33333333333,0,0,0
dr. light,25.0,8.33333333333,0,0,0
hypertj,25.0,8.33333333333,0,0,0
duckpimp,25.0,8.33333333333,0,0,0
miken,25.0,8.33333333333,0,0,0
mahie,25.0,8.33333333333,0,0,0
phex,25.0,8.33333333333,0,0,0
eltiti,25.0,8.33333333333,0,0,0
chewy,25.0,8.33333333333,0,0,0
dezno,25.0,8.33333333333,0,0,0
patty-wagon,25.0,8.33333333333,0,0,0
core,25.0,8.33333333333,0,0,0
wolfcry,25.0,8.33333333333,0,0,0
spade,25.0,8.33333333333,0,0,0
sylveonbae,25.0,8.33333333333,0,0,0
price,25.0,8.33333333333,0,0,0
tweli,25.0,8.33333333333,0,0,0
hyperbole,25.0,8.33333333333,0,0,0
nikku,25.0,8.33333333333,0,0,0
esuma,25.0,8.33333333333,0,0,0
da bear,25.0,8.33333333333,0,0,0
werewyatt,25.0,8.33333333333,0,0,0
hans_mawell,25.0,8.33333333333,0,0,0
thomas,25.0,8.33333333333,0,0,0
deep dimples,25.0,8.33333333333,0,0,0
mickeyrat,25.0,8.33333333333,0,0,0
electricgazelle,25.0,8.33333333333,0,0,0
levity,25.0,8.33333333333,0,0,0
4sk,25.0,8.33333333333,0,0,0
fractal,25.0,8.33333333333,0,0,0
voidstar,25.0,8.33333333333,0,0,0
zane,25.0,8.33333333333,0,0,0
sambo,25.0,8.33333333333,0,0,0
k8,25.0,8.33333333333,0,0,0
madguy,25.0,8.33333333333,0,0,0
redribb0n,25.0,8.33333333333,0,0,0
spaff,25.0,8.33333333333,0,0,0
karl,25.0,8.33333333333,0,0,0
pat,25.0,8.33333333333,0,0,0
sadfaps,25.0,8.33333333333,0,0,0
mojn,25.0,8.33333333333,0,0,0
falln,25.0,8.33333333333,0,0,0
high qi,25.0,8.33333333333,0,0,0
astumpyzombie,25.0,8.33333333333,0,0,0
paul d,25.0,8.33333333333,0,0,0
link,25.0,8.33333333333,0,0,0
emon,25.0,8.33333333333,0,0,0
gaon!,25.0,8.33333333333,0,0,0
urpasmash,25.0,8.33333333333,0,0,0
gwiio,25.0,8.33333333333,0,0,0
sussebass,25.0,8.33333333333,0,0,0
zetts,25.0,8.33333333333,0,0,0
rf!,25.0,8.33333333333,0,0,0
aperture,25.0,8.33333333333,0,0,0
neverpullout,25.0,8.33333333333,0,0,0
sandman,24.9887311423,4.55877603613,3,2,5
village mascot,24.9793399045,2.21794180982,11,14,25
lou_sanus,24.9726507596,1.45673842939,21,24,45
imdabes,24.9544618082,4.9329171002,2,2,4
tootmoses,24.9533545482,4.05879931914,3,4,7
yass2queen,24.9521629583,5.55029356187,1,2,3
shaddi,24.9295617786,2.77567858315,6,6,12
no~m,24.9289421578,1.86618703331,14,14,28
biz,24.9216086418,3.49561951372,3,4,7
three deaths,24.90039655,2.34751141651,10,7,17
girl,24.8919002125,4.65131565094,2,2,4
jc_chill,24.8816904935,4.66007647926,2,2,4
hayrow,24.8760716524,5.60963176016,1,2,3
olikus,24.8345186281,4.491736906,2,3,5
dasit mane,24.8054783952,5.29757846679,1,2,3
pidgezero_one,24.8030371179,4.92260328023,2,2,4
7blanks,24.7857655914,4.03426846924,3,3,6
tafokints,24.7543163787,5.98230366142,1,1,2
yeye,24.7491574915,4.26787440441,2,4,6
alex,24.6972337732,3.92244780764,3,5,8
schmerka berl,24.6945408355,2.51969328896,7,11,18
daddy's milk,24.6676866237,4.12856247254,3,4,7
blueman,24.6558311059,4.14457051057,3,4,7
soulbroker,24.6490965711,4.77612071047,1,2,3
dankestdad,24.6441605985,3.67631896172,4,4,8
barron,24.6389957691,5.14166158817,2,2,4
hotpocket,24.6351541742,2.51083025679,8,10,18
mmneggs,24.6320987066,3.37482023672,2,6,8
tetsu0,24.6262993259,5.03796166079,2,2,4
handles,24.619750563,2.10932311611,10,11,21
drinkwildturkey,24.6180947234,3.38178803424,4,4,8
dount,24.6060569127,4.09402006283,3,3,6
et,24.5920424129,1.87416785032,10,18,28
whuck,24.5828430357,4.01651529369,2,3,5
pupperina,24.5802390041,4.66785393449,2,4,6
thissidedown,24.5513665815,5.43925573599,1,2,3
aces,24.5437369718,2.6312397418,6,11,17
tmakk,24.5320583719,3.24729154585,5,6,11
fanboy,24.489218521,5.72537316694,1,2,3
cashhole,24.4825960328,5.40963255151,1,2,3
collin the conqueror,24.4582480014,5.06356359914,2,2,4
satch,24.4484190474,5.04404046701,2,2,4
dusttin,24.4448147746,2.20736387966,10,13,23
papaghanoush,24.4442375188,3.37521461961,3,4,7
milleneum,24.4441174345,1.9840269446,11,14,25
luigikid,24.3990684268,5.00184242285,2,2,4
jazzy jinx,24.3888989225,4.61063078292,2,2,4
pettanko-senpai,24.3844493572,2.65987920532,7,6,13
byff,24.3531958835,4.42616651113,2,2,4
tauvalian,24.3283622006,5.04985079081,2,2,4
chicken,24.3150350295,2.97943130127,5,7,12
gamer4life,24.3124970373,4.62810252074,2,2,4
reese,24.3021092979,4.43609296046,2,2,4
principal coffee,24.2389473032,2.54090020539,9,6,15
sombrero,24.2277990286,5.24583204617,1,2,3
esid,24.2138082084,2.14167107148,10,9,19
monkey,24.2033995405,2.03905179091,10,13,23
enemajoe,24.1892729792,3.24446187053,4,4,8
cillies,24.1677572378,2.11259558323,10,9,19
smashg0d,24.1473408161,5.37571815839,1,2,3
k-nut,24.1365368992,4.29427694186,2,3,5
drewgong,24.1282357867,1.77993307674,13,16,29
staysleepin,24.0954660122,2.88199251767,4,8,12
shamsavior,24.0908933525,2.14668978621,7,12,19
chevrium,24.0906027439,3.6859111458,3,4,7
skrull,24.0383943224,4.94518308631,2,3,5
gaggleforce,24.0323668,5.21688036149,1,2,3
dsj,24.026251184,2.66954850008,6,6,12
pzero39,24.0060847118,2.11666085713,10,15,25
sunshinetk,23.9911996257,4.72938122836,2,3,5
jinjo,23.9700897429,5.5704973186,1,2,3
natural brother,23.9671398218,2.89871507545,5,8,13
kevine,23.9477325873,5.60074788092,1,2,3
costaricancool,23.9301440452,4.56037777054,2,3,5
slippypickle,23.9214953438,4.27449255921,2,4,6
nuggzy,23.9133660777,4.78267472168,2,2,4
savior,23.9066200188,4.95478696927,2,2,4
wubbs,23.893608839,4.94075924348,2,4,6
camerino,23.893273065,4.18224975784,2,4,6
ders,23.8846919855,3.70820668501,5,4,9
jaquarium,23.8404794066,5.04087719999,2,2,4
khakis,23.8195168002,4.66275126303,2,3,5
grahamaglam,23.8164353171,1.97974151605,8,14,22
dirtcruncher,23.8081402995,3.34522410514,4,6,10
monad,23.768050229,1.50501833819,17,31,48
waldo,23.7646256745,4.19581934854,2,3,5
cmac,23.7624303046,3.29705171488,4,6,10
lotus eater,23.7597692894,2.80462491005,5,6,11
gaijilla,23.7335000994,5.89458141807,1,2,3
mr. biz,23.7210641953,5.05089869586,2,2,4
dsyr,23.719595816,3.86643268625,2,2,4
probers,23.6805130162,4.62729514735,2,2,4
truffleshuffle,23.6788769285,4.52693030002,2,3,5
zenaga,23.6761009151,5.50042648943,1,2,3
icho,23.662896248,4.88366621654,2,2,4
puncayshun,23.6270953275,3.55868476606,4,3,7
sk,23.6269155748,5.64613700625,1,2,3
majin_bukkake,23.6209904975,1.94893229776,11,16,27
bre,23.6163888976,1.82625089603,12,15,27
kurow,23.5984776565,7.48018805956,0,1,1
hunter,23.586621812,1.6881390241,16,17,33
wheels,23.5759108849,2.18420701543,8,7,15
searing scar,23.574866726,4.41158887627,2,4,6
twan,23.5612911801,3.21473099425,5,3,8
b.i.,23.537418878,1.9579900268,9,13,22
izoo,23.5371695413,5.42181231484,1,2,3
capos,23.5340525118,1.11547203647,43,54,97
file,23.5146637881,2.60560575199,8,5,13
gera,23.4898486031,5.53310149373,1,2,3
kingkool,23.4818263461,2.48809398051,8,10,18
arctic,23.4684294881,5.40148296815,1,2,3
moze,23.4592288604,4.98526512836,1,2,3
chronicmexican,23.4531854804,2.45060759724,6,12,18
derstuk,23.4475128708,2.16563248276,10,12,22
widdy,23.4354337789,1.43157515531,25,33,58
sonicfuzz,23.4101932962,2.02812940932,12,15,27
moustasher,23.387082872,1.67983252986,15,23,38
-philip coast philip-,23.3697043425,5.25692690117,1,2,3
pochilin,23.3686415636,3.89578154083,3,5,8
steamfriedasian,23.3621246951,5.73391255533,1,2,3
rawdog,23.3586974349,5.06412893915,2,2,4
wal,23.3419750632,5.72588669497,1,2,3
sph,23.27614359,4.5186933381,2,3,5
thrillhouse,23.2739966218,1.83701831993,11,17,28
andy,23.2650691807,2.0218814136,10,12,22
bhol,23.2226241346,2.26496271562,8,11,19
jaapoh,23.2060093275,3.5654062704,3,4,7
neth,23.1861020266,5.49320539377,1,2,3
qtip,23.1471201424,5.96320374501,1,1,2
dwreck,23.1427050378,5.50870913819,1,2,3
chino san,23.0985416563,5.4142944831,1,3,4
clefairy as mew,23.0927379524,4.95371121424,2,2,4
bottle opener guy,23.0632797645,3.36323503128,4,4,8
aguos,23.0598851704,5.54794149378,1,2,3
xanz,23.0545148072,5.12641315059,1,2,3
matt,23.049131858,3.23597422412,3,5,8
masquerade,23.0480593414,5.50126583567,1,2,3
ardent rage,23.0390518825,5.33053236201,1,2,3
bimbo,23.0263984695,2.95045653793,4,5,9
dex,23.0157579329,7.26303928778,0,1,1
garv,23.0087701032,3.94332664324,2,2,4
gibbles,23.0028076724,4.98614184348,1,2,3
kman,22.9932321123,5.67901093998,1,2,3
minymidge,22.9912843114,2.16947676747,7,16,23
ajbcdefg,22.9703536736,1.44131480712,22,29,51
billbacon420,22.9677591477,1.42960236123,20,31,51
duncs,22.9585213026,1.45949633508,24,29,53
ditto,22.9323456375,2.34300401941,7,11,18
pluto,22.9093362416,5.56220097291,1,2,3
bean,22.8699120479,1.75300530857,12,25,37
biscuit,22.8662146651,5.74469940782,1,2,3
hotspank,22.8643621877,1.67117766991,16,22,38
nigel_thornberry,22.8525552656,5.24517339621,1,2,3
elu,22.8452924431,2.06505456822,11,18,29
brny,22.838748422,5.26669002508,1,2,3
zibba,22.8170969194,7.24300767435,0,1,1
dankpank,22.7986701998,1.36562605078,23,33,56
silver,22.7753430854,3.15323831702,4,6,10
racilor,22.7637274511,4.67748051142,1,4,5
greenblob,22.7601812162,2.9348839707,4,7,11
goosewithsocks,22.7552127802,1.56307880683,18,23,41
bflakes,22.7497738812,1.92311161493,11,16,27
bodacious,22.7456335897,4.10770698892,3,4,7
bonerstorm,22.7131543348,5.03759629022,1,2,3
egg,22.6868315234,7.13619990605,0,1,1
verwaltung,22.6867102224,5.67101579923,1,2,3
drewskii55,22.6773296708,7.1998936357,0,1,1
crazyk115,22.675195546,5.13123091144,1,3,4
tangerine,22.6691944944,2.01277238806,13,15,28
xif,22.6534817717,7.12557083651,0,1,1
nanagens,22.6390808137,2.84228625052,7,5,12
aisengobay,22.6293808255,5.02187166669,1,2,3
foda,22.6264101863,1.94776042608,11,14,25
boh,22.6263883891,5.22409885802,1,2,3
cooljoe,22.6161343304,5.22917378086,1,2,3
cyan can,22.597335078,3.57011809798,3,6,9
jlo,22.5827565807,2.37209025257,9,10,19
cuppajoe,22.5614711416,3.98912966001,3,4,7
asaaj,22.5613341396,3.19741554592,4,4,8
rgood,22.5504742507,5.20983845717,1,2,3
evals,22.5497261156,5.26109394584,1,2,3
robnu,22.536172251,5.27296940229,1,3,4
schlag,22.5295736344,5.64093463869,1,2,3
zhao_guang,22.5277237515,5.28057703468,1,2,3
keagsbsmashin,22.505682607,4.93161471885,2,2,4
stylisland,22.4970786889,4.90556046625,1,2,3
chiefreaper,22.4961205317,5.37600170459,1,2,3
lldl,22.4754387364,5.54602983821,1,2,3
momdameatloaf,22.4701881379,2.75726912308,5,6,11
hotahota,22.4607652144,1.7378241071,17,14,31
bohemian milk,22.4410234019,5.64191828862,1,2,3
mourin,22.436189438,5.53322447519,1,2,3
rythemretrn,22.4257927027,5.54390698698,1,2,3
okay,22.4198310889,5.79932476972,1,3,4
leaf fc,22.4135995398,3.30091393833,4,6,10
hsf,22.3577182729,5.21749074515,1,2,3
tokaji,22.3418384892,5.72549549374,1,2,3
the professor,22.3357851457,3.93517245049,3,5,8
panda,22.3286132302,2.87013395625,5,9,14
maaron,22.3235126558,5.2279102694,1,2,3
h00n,22.3135282538,3.56189911967,2,4,6
rebel scum,22.309971187,3.35235257188,3,5,8
zergos,22.2995649861,3.28093350751,4,6,10
yakal,22.2950630033,5.45881954507,1,2,3
happens,22.2866227951,3.38278268821,3,5,8
reckless,22.2777886196,5.54771180862,1,2,3
ensindic,22.2776294199,1.96758684844,9,16,25
green eggs and spam,22.2713050426,3.97567059929,2,4,6
sun vulcan,22.2633593669,3.97593915296,2,4,6
adrian,22.2449221962,5.4939042246,1,2,3
moonshoe,22.2354555212,1.22620410225,30,49,79
geekliftus,22.2334848055,5.51993490319,1,2,3
train_town,22.2182491195,5.25970810876,1,2,3
squible,22.2003541632,2.73905390243,6,7,13
prism,22.1844388475,5.77138158298,1,2,3
toez,22.1708132151,5.1827586053,1,2,3
grrg,22.1694266071,2.56908181559,6,11,17
ocelot,22.1634325145,2.14198977726,6,17,23
dr.yonz,22.1540585093,2.1941313094,8,10,18
cbones,22.1425979996,5.17784168517,1,2,3
mickeyo64,22.1102013139,5.03581556231,1,3,4
omar,22.0873057251,4.52911632269,2,4,6
giraffe,22.0832446758,5.52720444839,1,2,3
mr. tit,22.0683807418,2.53944359678,5,7,12
nikademiks,22.0497594835,3.44920663187,5,3,8
mrryanness,22.0451209734,3.72964228852,3,7,10
crip,22.0417499629,5.72015962435,1,2,3
honeybadger,22.0417499629,5.72015962435,1,2,3
hamburglar,22.0313772247,5.47262274073,1,2,3
wowzers,22.0130569538,3.63237880752,3,5,8
hbrw-hammer,21.989450955,5.19683618143,1,2,3
mrpoo,21.9694395301,5.5090539933,1,2,3
banana fiend,21.9571408911,5.00477127102,1,2,3
zarc,21.9523180178,5.3661603852,1,2,3
han,21.8966597569,5.31977588561,1,2,3
papasquat,21.8888349827,1.62546406469,12,27,39
kzidek,21.8867795024,5.53430238446,1,2,3
multiball,21.8779165857,1.67450939586,15,24,39
sebson,21.7690532328,4.86714048255,1,3,4
kristoff,21.7592115369,1.911615007,12,19,31
kaddy,21.7448383797,6.97871477739,0,1,1
iceking,21.7267345236,2.75773647443,5,12,17
pizzajokes,21.7162054905,5.50815225737,1,2,3
paco [larkin],21.7159475813,5.45508770932,1,2,3
fawnco,21.6867950646,5.49425252058,1,2,3
burnt out ninja,21.6867950646,5.49425252058,1,2,3
keatsta,21.6842966976,5.27368510604,1,2,3
cardoso,21.6780577038,5.47180539926,1,2,3
eggmcmuffin888,21.6697922362,2.48303021985,5,9,14
h2o,21.6588463589,2.88120456063,6,6,12
gumbolaya!,21.6434793433,5.28700972786,1,2,3
dax$,21.6348504492,2.65517387843,6,6,12
elated,21.62548673,2.0588089455,9,16,25
dair,21.6238536672,3.18147761202,4,4,8
halffulla,21.6228315038,3.48077405043,3,5,8
moonlight,21.5957121794,2.70338360447,4,9,13
calzum,21.5727920772,5.33794640948,1,3,4
yolochi,21.5551316173,2.38933036985,7,13,20
slartibartfast42,21.5328392932,4.28071789839,2,4,6
macintosh,21.5316738528,3.43726461742,3,6,9
evab,21.5281310611,5.45654170068,1,2,3
l3w!,21.5261013011,5.11492796981,1,2,3
ondas,21.51339165,3.48788136518,3,5,8
zombie!,21.5047657545,5.52858492613,1,2,3
anathema,21.5047657545,5.52858492613,1,2,3
kossismoss,21.5047657545,5.52858492613,1,2,3
jirachinick,21.5047657545,5.52858492613,1,2,3
glennwood,21.5047657545,5.52858492613,1,2,3
zwephy,21.5047657545,5.52858492613,1,2,3
trevman,21.5027061159,5.10402665286,1,2,3
weirdy man,21.4938394777,5.32664823819,1,2,3
sadu,21.4831253742,5.56869670732,1,2,3
tipc,21.4715447806,2.90636202966,4,8,12
dugdiaz,21.4617736838,2.88379965621,3,7,10
second boss,21.4589013652,3.51995394969,3,4,7
tubby!,21.4588417926,4.56514615723,1,4,5
xiivi,21.4496962562,2.85386214119,5,9,14
jmabate,21.4375021927,5.28753891929,1,2,3
fearlesscaboos,21.4290211813,5.32540817218,1,2,3
gray,21.403311368,2.66468458269,5,8,13
v-bomber,21.4000216092,4.19284654502,2,4,6
elrond,21.3828160484,2.44967625636,6,13,19
napkins,21.3422581477,5.51129103904,1,2,3
whoopiecow,21.3422581477,5.51129103904,1,2,3
bubby,21.3396390978,5.35310713357,1,2,3
boink,21.3298650991,3.33667040771,4,5,9
pikasneeze,21.3091540876,2.75483291943,5,6,11
vinvinn,21.2928565061,2.28412382226,6,11,17
fish,21.2727927064,7.11056318404,0,1,1
minusev,21.2310105936,7.09851357382,0,1,1
chunky's cheese,21.2198262173,6.41500008396,0,2,2
frostbyte,21.2183791303,3.47565182334,3,7,10
a dog,21.2006338247,5.2780201564,1,2,3
jdp,21.1604359188,5.11371184679,1,2,3
peaceful soujourner,21.1174151603,5.11780193147,1,2,3
blue bear,21.1002964099,5.55587524657,1,2,3
bombproof,21.0855777526,1.81245102358,12,17,29
frog,21.0756367448,3.2481156617,4,7,11
shasta,21.070209472,5.51002169606,1,2,3
kavon,21.070209472,5.51002169606,1,2,3
mizbiz,21.0506288678,3.26501420951,4,4,8
hungrybox,21.0467231473,4.48911181511,2,4,6
static,21.0361805828,3.56635009013,3,5,8
bawdbabe87,21.0350734378,2.27093813915,10,14,24
fingerblast,21.0282944416,4.56717243747,2,2,4
zouzy,21.018882577,5.55999916596,1,2,3
doby,20.955388899,4.84043951971,1,2,3
hipo,20.953075175,5.25579614463,1,2,3
catastrophe,20.9451507984,3.70434128256,3,4,7
tallboi,20.8761552848,6.62294419257,0,1,1
fuzzyness,20.8757588528,5.24485548902,1,3,4
dr combos,20.874636823,3.28180564257,2,8,10
java boy,20.8688053303,5.51600461343,1,2,3
yungpurp,20.8565440875,6.68399882972,0,1,1
apparition the ambassador,20.8562283328,1.20559826971,25,55,80
seantos,20.846849983,1.94282518724,11,23,34
big tone,20.8429637361,7.05911462831,0,1,1
ttp,20.8037683646,3.4515325121,3,6,9
zad,20.8025162392,3.39146514183,3,7,10
eliot,20.800150921,4.9216372622,1,5,6
fork?,20.7954624437,4.94915592418,1,3,4
dankey kang,20.7946741691,2.15381224203,7,17,24
lucky_hamburger,20.7900182536,2.94930984478,4,7,11
cookie,20.7811011744,6.26168718267,0,2,2
teflon ron,20.7743167383,3.31871768139,2,6,8
zach777,20.7736677983,6.44988557306,0,2,2
mojo,20.758940526,5.19849799532,1,2,3
lalo,20.7455633083,4.13912238987,2,4,6
buttery adachi,20.7363871153,4.64326378998,1,3,4
zerobombjake,20.6540171365,2.04736155085,9,15,24
brotherly,20.6317879354,2.75429141865,4,7,11
kintsukuroi,20.6283406585,2.48670613233,3,8,11
queso,20.6114963632,2.82435597823,3,8,11
sfat,20.60416798,7.17147558733,0,1,1
sherb,20.60416798,7.17147558733,0,1,1
mystery,20.60416798,7.17147558733,0,1,1
drewjames,20.60416798,7.17147558733,0,1,1
josiab,20.60416798,7.17147558733,0,1,1
silent skyler,20.60416798,7.17147558733,0,1,1
benbook,20.60416798,7.17147558733,0,1,1
fs shampoomaster,20.60416798,7.17147558733,0,1,1
thissideup,20.60416798,7.17147558733,0,1,1
uprowr,20.60416798,7.17147558733,0,1,1
akajumo,20.60416798,7.17147558733,0,1,1
ragingcherry,20.60416798,7.17147558733,0,1,1
4 phri,20.60416798,7.17147558733,0,1,1
jad,20.60416798,7.17147558733,0,1,1
phalanx,20.60416798,7.17147558733,0,1,1
changed man,20.60416798,7.17147558733,0,1,1
bunmira,20.60416798,7.17147558733,0,1,1
5000candlesinthewind,20.60416798,7.17147558733,0,1,1
nfreak,20.60416798,7.17147558733,0,1,1
k-man,20.60416798,7.17147558733,0,1,1
captain murphy,20.60416798,7.17147558733,0,1,1
nannose,20.60416798,7.17147558733,0,1,1
kayo,20.60416798,7.17147558733,0,1,1
lonk,20.60416798,7.17147558733,0,1,1
akito555,20.60416798,7.17147558733,0,1,1
yung god,20.60416798,7.17147558733,0,1,1
penance,20.60416798,7.17147558733,0,1,1
nyani,20.60416798,7.17147558733,0,1,1
nuro,20.5843013507,5.43716215887,1,2,3
maher,20.5765130073,5.42879585881,1,3,4
jaws,20.5676658066,5.35482917924,1,2,3
weedlypuff,20.5611504927,2.81724165284,4,10,14
icactusdog,20.5404721631,1.16536065368,31,76,107
moist,20.5281445459,4.25078653283,2,4,6
haf,20.5266448359,2.44535889729,6,10,16
flatline,20.5164882806,5.24452888369,1,2,3
thenuge,20.5013392426,5.04003806029,1,3,4
joel,20.4705055351,2.79986883805,5,8,13
three beers,20.4543754496,2.69576417654,4,8,12
heartsdealer,20.4352434283,4.22339731315,2,4,6
kosher,20.4298509103,1.73906775376,13,21,34
voff3,20.4221610927,7.01236351457,0,2,2
barrels,20.4103697104,3.86287339816,2,6,8
throwz?!,20.3712944246,5.17095114858,1,2,3
homemadewaffles,20.3612733202,6.92690169084,0,1,1
cormander,20.3546233907,2.70442929364,4,12,16
el rabbito,20.3414295746,5.22933943015,1,3,4
mr baninawi,20.3034225788,4.50399658276,1,2,3
hero,20.3003305973,6.88831159169,0,1,1
acerunner,20.2865410515,3.8297123989,2,5,7
spunker,20.2808413718,6.64362796217,0,2,2
e-jager,20.2665174268,4.9661523636,1,3,4
caelan,20.204195046,7.0610632401,0,1,1
papa,20.1887172218,3.05256242719,4,8,12
jag,20.1785676558,3.03024802507,4,8,12
butcher of bakersfield,20.1709924669,3.98886789201,2,5,7
stormcrow2,20.1576060123,2.32530166852,5,12,17
mikeyp,20.1574699988,2.64353390735,5,10,15
shug,20.1423880259,3.31203193609,3,8,11
fritz wethermyb,20.1349372545,6.19961318923,0,2,2
mjim,20.1284765276,2.70044223795,4,12,16
izze,20.0883722622,4.69145056366,1,4,5
aegeze,20.0787255827,3.37958218806,3,5,8
howdy,20.0421516151,2.07206144965,11,16,27
nich,20.0269439574,3.24617540531,3,10,13
zephr,20.0265585836,4.95258600964,1,3,4
mighty afro dighty,20.0260934361,3.67034874339,2,4,6
accru fenix,20.0065974244,2.8983970195,3,10,13
aeremox,19.9808911682,2.30886198931,6,10,16
b vu,19.976770482,6.56438077202,0,1,1
depressed eagle,19.9668557046,4.71517261952,1,3,4
tallyshell,19.934214378,5.03744674898,1,2,3
weatherman,19.9276209784,6.05371578566,0,3,3
kiwi,19.9119451766,3.21232311883,2,7,9
stark,19.8985862487,2.12832123961,7,15,22
pokmo,19.8963272368,2.97911512717,3,8,11
bunme,19.8939607881,4.330407032,1,3,4
kingcake,19.8858301331,3.92330137603,1,3,4
pika,19.8665160974,4.50476058035,1,4,5
nineball,19.8592830513,3.00760311161,3,7,10
dad's musical erasers,19.8497643097,6.35255124253,0,2,2
frogman [charette],19.8470685379,6.53515646093,0,2,2
mikelangelo,19.8411042163,6.45109191965,0,2,2
king robin,19.8214996321,5.18757257798,1,3,4
spt,19.8163018158,6.39220654309,0,2,2
danny,19.8128864133,6.83164246741,0,1,1
russellsprouts,19.8040547441,1.18539069482,29,75,104
maximum can,19.7913963128,6.17551588645,0,2,2
james bong,19.7003930269,3.04935717356,4,9,13
elvis,19.6726988324,2.07642122224,7,14,21
memez,19.6373597778,3.27535703789,3,5,8
sebastian,19.6363896958,2.92186740849,4,8,12
rogue1wasjustok,19.5957545797,2.87915729091,3,8,11
muse,19.5659092403,2.17145076244,8,14,22
yaron,19.5195470768,3.68960019688,1,6,7
fiasko,19.4973300369,4.80703150723,1,3,4
kuso,19.4888408706,5.19655189281,1,3,4
danno,19.4480883685,5.26348120732,1,2,3
dimension,19.4061385287,6.20651346822,0,2,2
diveo,19.3915731995,2.23139315659,6,18,24
goose,19.38281364,3.65274590632,2,6,8
fred,19.3513731126,4.82057914582,1,4,5
lil devil55,19.3372656866,6.50140744992,0,2,2
fumofuu,19.3003820949,6.70094005858,0,1,1
qu'importe,19.295162511,3.23332407194,4,4,8
jive turkey,19.2874695919,4.24507291085,1,4,5
veen,19.2649590252,6.50769593739,0,1,1
magic,19.2443864602,3.12675618889,3,5,8
houndour,19.2413526596,4.73921565466,1,5,6
missingn0,19.1950717181,6.10648839204,0,2,2
krypto,19.1841673017,4.81601129522,1,4,5
rush,19.1758677885,2.8817590327,3,9,12
bluebear,19.1508560766,2.67997067357,5,10,15
husker,19.1407514841,4.23594874856,1,5,6
laugh,19.1329887826,2.80794514822,4,10,14
crazy_cubano,19.1312285195,2.27386532888,7,11,18
slatts,19.1050043651,1.75887337642,10,27,37
digital cannon,19.1032207775,2.87823742096,4,8,12
bleachfanboy4life,19.0684796157,5.04607769303,1,3,4
brown_omega253,19.0491830601,6.33093343935,0,2,2
k,19.0368392144,5.94893247223,0,2,2
supernuggit,19.0116038259,2.47479015333,5,12,17
esmod,19.004211349,6.50799591405,0,2,2
skubtard,19.0028728103,6.87267909617,0,1,1
fs mook,19.0028728103,6.87267909617,0,1,1
jiffypop23,18.9780743592,3.36022647472,3,6,9
rabizkoshik,18.9387563269,4.96521521123,1,4,5
kingcool,18.9351088349,3.64474619053,2,6,8
guccipivotmaster4000,18.9347382351,6.43705129894,0,2,2
dixoncider,18.9221109721,2.98199140416,4,9,13
ego,18.9220364506,6.43080985891,0,2,2
precookedbread,18.9052180392,6.13144583345,0,2,2
engdrew,18.8812855368,2.71470020541,3,9,12
dcmaster,18.8783581199,3.30966071955,3,6,9
obby,18.8602848584,6.3694311932,0,3,3
luwolf,18.8528289655,6.29676283428,0,2,2
fry,18.8388092651,1.99223001103,8,22,30
quentendo,18.827404956,6.15822479675,0,3,3
muthalova7,18.8075240657,3.29842719069,4,5,9
neat,18.8056120866,2.45527482509,4,17,21
blizz,18.7928519856,6.79635578797,0,1,1
turtlpower,18.7895018776,6.35251859374,0,2,2
littlespoon,18.7802214939,6.35987476929,0,2,2
bananabolts,18.7763373683,4.13202258996,1,5,6
mr.e [rohr],18.7703709704,6.52341434227,0,2,2
flare,18.7497987993,4.81992529848,1,4,5
cagt,18.7334711485,1.43579002754,19,34,53
iacme,18.7083010866,5.87564021133,0,2,2
polarbair,18.7060169502,2.19576860781,8,18,26
duck chris,18.6843486974,6.48895532793,0,2,2
shreddern64,18.6695644854,4.6801348089,1,3,4
fen,18.6651960945,4.60992013254,1,4,5
kali mist,18.6575953156,4.74070069344,1,5,6
takuto,18.6220374586,2.53042808258,5,10,15
jgin,18.6138243448,5.91644299953,0,2,2
kieuarty,18.6114712808,6.46332300431,0,2,2
cracker jones,18.6098772232,1.60705079491,13,32,45
youtwo,18.6056078068,6.49184921396,0,2,2
captain hook,18.6050609253,3.02077189503,3,6,9
qerbstomp,18.5907954406,3.12730340598,3,12,15
ltdan,18.5599920405,4.30735301086,1,4,5
r.o.m.,18.5588529466,6.38820575423,0,2,2
kl3an,18.5588529466,6.38820575423,0,2,2
pokeiman_master,18.5516219727,6.44406310517,0,2,2
crazycat,18.5458132225,3.1680364267,3,6,9
nathansandwich,18.5340011659,3.3684395445,3,7,10
tdp,18.5322048421,6.27670782881,0,2,2
lecceo,18.5224563478,6.04122538682,0,2,2
failcant,18.5036619979,6.53954925511,0,1,1
tbone,18.4739919389,6.26372813517,0,2,2
nagurnimaster,18.4700890997,6.22509745584,0,2,2
superkirby,18.4611593024,6.07126152759,0,2,2
dance!!,18.4535702783,4.27618587267,1,5,6
ender,18.4527495297,3.08694326522,5,6,11
pugdaddyfre$hlyfeogg*flva,18.4491791431,6.2655689814,0,2,2
reno,18.4482558464,5.7933455433,0,2,2
myninja,18.4376385639,4.38075340335,1,4,5
professortoke,18.4282005878,6.40611160598,0,2,2
swerve,18.4029930603,6.39919902858,0,2,2
stdangerous,18.3869320511,6.13518467314,0,2,2
big d squirrels,18.3847671628,6.39555690356,0,2,2
master jay,18.3609401588,6.39052231831,0,2,2
shwang,18.3577767565,6.2521714548,0,2,2
nami,18.3449675847,6.12168390994,0,2,2
albinosaurus,18.3408647977,6.15904885894,0,2,2
charlie harper,18.3330999134,6.38313840111,0,2,2
arcangel,18.3324667543,4.29068147522,1,5,6
hasme,18.3202081908,5.59655801937,0,3,3
silky johnson,18.3148345516,3.28556672948,2,8,10
oxycontin,18.3049578438,4.56472838053,1,4,5
mntd,18.3037506343,3.37480634304,2,7,9
kitchensock,18.3006351517,2.21693218024,6,12,18
blackf00t,18.2957405055,6.11791947838,0,3,3
quinceprince,18.2944270184,6.23604937648,0,2,2
tangpootie,18.2496769783,2.52754568061,5,12,17
jesusisking,18.244999185,6.14113063168,0,2,2
xlax,18.1874527175,4.71791538095,1,4,5
blues,18.1872371134,4.80984283879,1,4,5
uncle e,18.1734701958,2.74462386073,4,7,11
elmustachio,18.1178019254,6.11091424803,0,2,2
chi-fence,18.1033327615,4.40195130045,1,4,5
shawarma habibi,18.1006083149,3.43125374474,2,6,8
jdeezel,18.096134607,6.31705839702,0,2,2
tylenol jones,18.0758497583,6.32077271178,0,2,2
avian,18.0712867461,6.31842389736,0,2,2
erk,18.057496334,6.31248192558,0,2,2
broonz,18.0501517673,1.82139790617,10,27,37
g-rabbit,18.0483745542,2.54037432788,5,12,17
sweaters,18.0428187692,6.46387437135,0,2,2
warmachine1919,18.0428187692,6.46387437135,0,2,2
drhino,17.9980023599,6.32119878345,0,2,2
jpoptosis,17.9980023599,6.32119878345,0,2,2
astropancakes,17.9980023599,6.32119878345,0,2,2
snack?,17.9980023599,6.32119878345,0,2,2
firefly,17.9980023599,6.32119878345,0,2,2
yam$,17.9980023599,6.32119878345,0,2,2
lexi,17.9729324925,5.92956035083,0,2,2
lights,17.9722012086,6.29535962389,0,2,2
goshzilla,17.9601485495,2.60436879826,4,11,15
beaver,17.9564848443,6.3115571796,0,2,2
armagreggon,17.9267158367,3.49503582211,2,5,7
√°1,17.9023688237,2.59498605215,2,11,13
frame,17.8959125787,2.38077770585,4,19,23
pajhomas,17.8627808696,4.28722969581,1,4,5
itg,17.8551620845,6.67621935994,0,1,1
ebay,17.8407852112,6.26851580688,0,2,2
dhir,17.8270005524,6.29388615473,0,2,2
akiva,17.8270005524,6.29388615473,0,2,2
chaos pro,17.8270005524,6.29388615473,0,2,2
mulkster,17.8270005524,6.29388615473,0,2,2
jfm,17.8270005524,6.29388615473,0,2,2
legoman,17.8270005524,6.29388615473,0,2,2
bc_burns,17.8270005524,6.29388615473,0,2,2
armor,17.8270005524,6.29388615473,0,2,2
espparadox,17.8253956875,1.65904121121,11,33,44
brambramjam,17.8232000718,6.04605326041,0,2,2
ccm,17.8068891701,4.04827436207,1,6,7
mrpoopee,17.7976858179,4.34727508875,1,3,4
massimo,17.7929138053,5.80630293942,0,3,3
austntatious,17.7829509186,6.06931121416,0,2,2
trogdorbad,17.7767969922,4.8798480296,1,2,3
jello,17.7665862903,3.25478540416,2,11,13
aerodet,17.7621992968,6.37995413731,0,2,2
nadamoor,17.7581945491,6.26709394311,0,2,2
lyra,17.7442372526,5.84555664799,0,2,2
tehz,17.7404725782,3.39001600145,2,8,10
rillocks,17.7295521616,5.42338649225,0,4,4
frogge,17.7291978431,5.91314686953,0,2,2
jackmehoff,17.7166145056,5.86450347919,0,2,2
charlie,17.7006913652,6.02158775086,0,2,2
liam_butler,17.6673384456,6.26628461383,0,2,2
matt47,17.6673384456,6.26628461383,0,2,2
colt,17.6613529856,6.33021997137,0,2,2
 ô·¥è·¥Ö·¥Ä·¥Ñ…™·¥è·¥ús,17.6562073261,3.89648155772,1,6,7
general1712,17.6251596911,5.48535296578,0,4,4
maxi,17.6227902384,6.22931743478,0,2,2
whitegrizzly,17.6211632096,6.0044317998,0,2,2
pigwick,17.6145656845,5.7986697379,0,2,2
scootieloo,17.6025155386,5.99030365635,0,2,2
chibaco,17.59578223,2.74225143526,4,14,18
jollie,17.5851838162,1.69196419351,11,34,45
the drew,17.5679362572,2.44397081029,4,16,20
bozz,17.559839839,6.18922189329,0,2,2
blank,17.5269841039,5.98245346039,0,2,2
rodan,17.5087484509,5.80398202432,0,2,2
coolguy76,17.50829629,3.40080160116,2,6,8
cochran,17.5077085197,4.62597946179,1,5,6
leet,17.4860988006,4.18175050908,1,6,7
gambit,17.4724485757,6.03130753421,0,2,2
maestro,17.4665216506,6.23929361131,0,2,2
chinstrap,17.4649334833,4.56998857617,1,4,5
mechanicalmarine,17.4535034222,6.30713173229,0,2,2
catlover321,17.4273629095,4.24425822915,1,4,5
scraggus,17.4207899857,6.18548881364,0,2,2
ponkapa,17.4024119223,4.13181396478,1,8,9
juan doe,17.387512858,6.29179480407,0,2,2
capsui,17.3777696809,4.18759727911,1,7,8
cennis91,17.342682148,3.60358378861,1,11,12
hollow,17.3321861393,5.18723048733,0,3,3
sunkin,17.3174002288,2.80703674736,3,9,12
jonnjonn,17.3164734442,1.60354813756,11,37,48
beets,17.3124066278,5.63406210559,0,2,2
sad,17.3097710331,6.27674314988,0,2,2
spammalanche,17.3002319546,5.77018147601,0,2,2
harmless,17.2905728248,6.22322606387,0,2,2
mikeyg,17.2894835768,5.66175718426,0,2,2
luka,17.2807209573,3.6801609486,2,6,8
highlyeducational,17.2602278329,6.07035824737,0,2,2
louieg,17.2309667725,5.92776788088,0,2,2
spell,17.2297182207,3.42277004132,2,7,9
caprigon,17.1913245938,5.86071904972,0,4,4
iamlazee,17.1861337018,5.94449519045,0,2,2
lv20ninja,17.1802136466,3.22931746815,3,7,10
ohhhbreezy,17.1645697169,4.37309275394,1,4,5
ppdmd,17.1573329149,6.26923433457,0,2,2
holosly,17.1573329149,6.26923433457,0,2,2
beech,17.1568960682,3.35777937732,1,12,13
superflopp,17.1531058407,2.6535722911,3,9,12
master j.j.,17.1358355436,6.24039459921,0,2,2
jgly,17.1215650399,4.2410114631,1,4,5
kraken,17.1082289074,6.27707797796,0,1,1
starcutter,17.1011463592,6.0665411989,0,2,2
driftintheabyss,17.1009098272,6.2415552758,0,2,2
amaya,17.0988004859,6.241919664,0,2,2
dinner,17.0933637711,6.08039702859,0,3,3
eltrion,17.0678247458,5.90984228943,0,2,2
sam,17.0659865662,5.90317544352,0,2,2
mr_sharpie93,17.0643868798,6.22653035915,0,2,2
pale,17.0588200426,3.43089306965,2,6,8
zarfon,17.0353081779,6.09705358847,0,2,2
hotsauce,17.0332175264,2.94175165675,3,8,11
ravioli,17.0284430048,6.30597887962,0,2,2
fj20,17.0162023864,2.19709381006,7,15,22
black rob,16.9946507075,6.21682728317,0,2,2
drlight,16.9870335546,5.93536565379,0,2,2
myroknpancakes,16.9831057439,3.33701816358,2,8,10
kastakatter,16.9651663509,5.6511482112,0,4,4
sianvar,16.9633447285,6.49717448643,0,1,1
giggitoxin,16.9572689606,6.19807969429,0,2,2
d-tek,16.9273178368,6.23983584333,0,2,2
sambook,16.9273178368,6.23983584333,0,2,2
15(ichigo),16.9273178368,6.23983584333,0,2,2
shadow light master,16.9273178368,6.23983584333,0,2,2
azzy,16.9273178368,6.23983584333,0,2,2
gaymer,16.9273178368,6.23983584333,0,2,2
dd,16.9273178368,6.23983584333,0,2,2
zurdo,16.9273178368,6.23983584333,0,2,2
riseup93,16.9273178368,6.23983584333,0,2,2
sfgman,16.9273178368,6.23983584333,0,2,2
grraffe,16.9273178368,6.23983584333,0,2,2
beekle,16.9273178368,6.23983584333,0,2,2
rickter_scale,16.9273178368,6.23983584333,0,2,2
themickeynick,16.9273178368,6.23983584333,0,2,2
paper tiger,16.9273178368,6.23983584333,0,2,2
tuna,16.9273178368,6.23983584333,0,2,2
uh what,16.9273178368,6.23983584333,0,2,2
raxcity,16.9273178368,6.23983584333,0,2,2
searcher,16.9273178368,6.23983584333,0,2,2
draxsel,16.9273178368,6.23983584333,0,2,2
red,16.9273178368,6.23983584333,0,2,2
qk shkz,16.9273178368,6.23983584333,0,2,2
irish,16.9273178368,6.23983584333,0,2,2
umi,16.9273178368,6.23983584333,0,2,2
waffles,16.9273178368,6.23983584333,0,2,2
heisenberg,16.9273178368,6.23983584333,0,2,2
miles,16.9273178368,6.23983584333,0,2,2
theycallmechris,16.9273178368,6.23983584333,0,2,2
jazz,16.9273178368,6.23983584333,0,2,2
aubfox,16.9273178368,6.23983584333,0,2,2
zombieheart84,16.9273178368,6.23983584333,0,2,2
muthaluva777,16.9273178368,6.23983584333,0,2,2
deku,16.9273178368,6.23983584333,0,2,2
edwin...,16.9273178368,6.23983584333,0,2,2
dinkleberg,16.9273178368,6.23983584333,0,2,2
yuxminato,16.9273178368,6.23983584333,0,2,2
abc,16.9273178368,6.23983584333,0,2,2
sunshine,16.9273178368,6.23983584333,0,2,2
j,16.9273178368,6.23983584333,0,2,2
mookie,16.9148029711,6.1975946788,0,2,2
jojohnson,16.8847446083,5.91443560749,0,2,2
bearrimshot,16.880384246,5.09988860939,0,3,3
vidya_james,16.8714405491,3.0883039599,3,8,11
joebro,16.8677406358,2.75052797751,3,10,13
altrusan,16.8409322726,2.91630929895,1,10,11
krutchby,16.8366823264,6.18674458762,0,2,2
dexter,16.8344044716,5.72200314937,0,3,3
shyguyking,16.8278588736,5.63034924809,0,2,2
comb,16.819848747,3.52710167236,2,7,9
bunnyblast,16.8164815237,6.1927063121,0,2,2
kohenbro,16.8078355606,5.51238629639,0,4,4
castaway,16.8048785331,6.06752345676,0,2,2
babycakes,16.7931217461,3.37676282303,2,6,8
m2cain,16.7880607121,6.19335774512,0,2,2
killer,16.7864279238,4.84316739317,0,5,5
sabe,16.7851040852,3.20451192643,1,7,8
superduperfanofboom,16.7666227916,6.17256403512,0,2,2
halqery,16.7630146573,5.26677527109,0,4,4
robslabgod,16.7588108091,5.72440338838,0,2,2
vex kasrani,16.7565999656,3.46994957928,2,9,11
keychain,16.7291453734,3.82896425571,2,4,6
saltking,16.7179026363,5.18974185004,0,4,4
jungle,16.6648474296,4.84351422785,0,7,7
jerzilla,16.6612408912,6.01798349036,0,2,2
rockmix,16.640668669,5.94271993402,0,2,2
rollock,16.6300312908,5.42999061067,0,3,3
falker,16.6112558748,3.31295061992,3,7,10
silentknight,16.6100905419,4.36393559366,1,6,7
scott,16.5972710002,6.15290821858,0,2,2
chibama,16.5811173495,4.23835908782,1,4,5
diet clorox,16.5566674011,2.96110160663,3,7,10
jpeghero,16.5542790113,5.72001128222,0,3,3
madara,16.5464477463,5.28748283274,0,4,4
instacover,16.5173598147,6.03304199256,0,2,2
atari,16.5111248706,2.4681212577,5,15,20
lunarnova,16.5038434056,2.03516967818,6,32,38
ejmp,16.4962755282,6.14526597827,0,1,1
dmolz,16.4943829733,4.97088513919,0,4,4
curiousplaces,16.4686400239,5.98022918707,0,2,2
jedipanda,16.4659275172,4.78548832619,0,5,5
beastly bad,16.450253649,2.96923308435,2,8,10
bogmyer,16.4083638818,5.8813774986,0,3,3
mattatari,16.3818816821,4.37046741309,1,5,6
pc jeff,16.3765259588,5.97535171364,0,3,3
nnaughtydogg,16.3475604048,5.11964984774,0,4,4
sugaaku,16.341235479,1.86681594695,9,22,31
magfmur,16.3354417012,5.811464978,0,2,2
nuggz,16.2852093148,3.61133172791,2,10,12
recneps,16.2601316871,4.30110904401,1,6,7
unknown presence,16.2192441136,3.20514273623,2,7,9
dr gibs,16.2021899007,5.23131951349,0,4,4
i do stuff,16.1859288188,3.54826115895,2,5,7
wilbur,16.1837164072,3.40579595964,2,6,8
duma,16.1333864411,3.63474623266,1,8,9
thegoat,16.1110336081,6.0577218926,0,2,2
rocktimus crime,16.0993988038,4.77461954279,0,5,5
lord horatio,16.0572892797,5.55792137196,0,4,4
i use tap jump,16.0472615734,3.71939973691,1,6,7
bill,16.0436099349,3.87400951394,1,6,7
scruffy mcwonder crumpet,16.0270056041,3.29389183374,3,7,10
jedisalazar,16.0197253748,5.71544602071,0,2,2
feathersruffled,16.0185561414,3.62425238886,2,4,6
bennypuff,15.9505859659,3.52897505225,2,7,9
elitescoringguy,15.9214963186,2.56414339609,3,14,17
mrkymrk,15.9033268205,4.79295813394,0,5,5
redwolf,15.8831330222,5.97846405882,0,2,2
noelkitten,15.8731837029,5.6545362116,0,2,2
12ties,15.8579871133,3.48240297499,1,5,6
eclipse,15.8514535054,5.17238060581,0,4,4
yolft,15.8471951439,2.41652909609,2,21,23
mixtape,15.83024583,3.48609384382,2,5,7
lampyshade,15.8182656238,5.42109246504,0,4,4
thedarkdreamer,15.802391653,6.01484204148,0,2,2
codytappen,15.7876556918,5.60934347854,0,2,2
tilt,15.7848183005,5.21207521622,0,4,4
jackkenney,15.760878246,5.6493277774,0,2,2
blahguy,15.7454563257,5.81008494948,0,2,2
don,15.7353309389,3.55981858299,2,5,7
turquoise,15.7325061833,3.26535091862,2,7,9
lloyd-black,15.7317314375,3.58250112751,1,8,9
twunt,15.723890594,2.9136209075,2,13,15
spaz,15.7179834222,4.20099047593,1,4,5
2%gay,15.7131552885,4.07037479325,1,8,9
vondo,15.7009495075,4.71229117812,0,5,5
norwayray,15.6848469543,5.25450295873,0,2,2
atlas,15.6546415334,2.32878816996,5,17,22
dk dredd,15.6475640437,5.91830761396,0,2,2
mm720,15.6456035156,5.58317595347,0,4,4
kobra,15.6168943269,3.16637525438,2,11,13
crug,15.584857303,5.84565477559,0,3,3
uncle onion,15.5522960143,5.93876560258,0,2,2
katiebug (sfk),15.5257668944,5.60340187496,0,2,2
aedrenaline,15.5125143786,5.74469940782,0,3,3
banana,15.4989919779,5.72015962435,0,3,3
valyrym,15.4989919779,5.72015962435,0,3,3
tydye,15.4962095478,5.71435404844,0,2,2
bennyboy98,15.4862446417,5.96174045904,0,2,2
swankeaboo,15.4652469438,4.83778031178,0,6,6
shimshamlando,15.4106406123,2.30790497408,4,28,32
fmaj7,15.3989977851,3.88227898093,1,6,7
t-bone,15.3776656819,3.41406562041,2,6,8
lou sanus,15.3638863627,4.56642182375,0,6,6
mzadeh,15.3403233553,5.22570020611,0,4,4
peacemaker,15.2870366322,4.38456294335,0,6,6
crestfallen,15.248411648,2.93255964475,3,7,10
tanuki,15.2414745664,5.77050178339,0,2,2
lvl99wizard,15.2287664412,4.90165913305,0,4,4
tron,15.2083248122,5.6069629933,0,4,4
mariokartmoney,15.2023991933,5.46979181665,0,4,4
godspeed,15.1920565176,4.07837800859,1,7,8
8oz,15.1774106967,3.92860342565,1,4,5
vnko,15.1666439342,4.14385055831,1,4,5
kezzup,15.1445160162,3.63066563633,1,8,9
bagel,15.1356957542,5.1963265951,0,4,4
dude wut,15.1302443839,4.51037891695,1,4,5
thisisgettingold,15.115537955,5.93072884891,0,2,2
warhorse,15.0475037924,3.76762123716,1,6,7
bung0o,15.0459137884,5.20225435693,0,4,4
zbomber,15.0439350813,4.93986498391,0,4,4
wiseacre,15.0173338761,3.59486148159,1,11,12
dyo,14.9975479187,3.5428821383,2,6,8
ir,14.9918279613,3.87710097623,1,6,7
dr-wumbo,14.9837672845,5.50489331454,0,2,2
rumi1819,14.8774943091,5.24462456669,0,4,4
ceephax,14.8596570391,5.78951951926,0,2,2
hufff,14.8522282231,3.63041248273,1,6,7
captainpugh,14.8447277654,5.52831626421,0,4,4
fig,14.8379883515,5.44294090835,0,4,4
adulix,14.7935449934,4.99541774313,0,5,5
bchill,14.734070562,3.21503933401,2,7,9
meccs,14.712500367,5.0227787396,0,5,5
snoosnoo,14.6679473011,4.23936465966,1,4,5
feartheday,14.6293006844,2.88757893125,1,18,19
cnasty613,14.605311191,3.4694229604,2,6,8
kevorkian,14.6046949044,2.82667750626,3,13,16
showtime,14.5887556482,5.82356153644,0,2,2
bear,14.5885043092,5.31724290645,0,4,4
drunkn smash,14.5529900135,4.5068725197,0,5,5
midgetto,14.532864018,2.31247603314,4,18,22
goofinhiemer,14.5222469663,4.98966185034,0,4,4
fmax,14.4895155373,5.50407742618,0,4,4
marfthekid,14.4838574609,5.52958296959,0,4,4
willie,14.4529609305,3.7680552645,1,7,8
jp3,14.4378800996,2.90446281409,2,6,8
apimpnamedslickback,14.4325932954,2.90417443398,2,9,11
nox,14.4229038589,3.02891507832,2,8,10
petty page,14.4159457502,3.26509459459,1,7,8
burmu,14.4082298553,5.35420278311,0,4,4
hiddenmi$t,14.3797230877,4.93835379199,0,4,4
ferguz,14.3550086587,4.93217853683,0,6,6
cag,14.3427522882,5.13575468617,0,4,4
armadillo,14.3382913891,4.55803170049,0,6,6
ngwn,14.3357587008,3.40094945965,1,9,10
sevshun,14.3066640669,3.4073934989,1,9,10
dennysgrandslambreakfast,14.2817644011,5.15765548501,0,4,4
yaks,14.2668147014,3.67727051245,1,8,9
ryden hope,14.2664534487,5.69617772613,0,2,2
usvn,14.2383336514,3.37496275612,1,11,12
rhubarb,14.2337738636,2.4028955104,3,18,21
adam duncan,14.2262331692,3.28980259237,2,6,8
spaghetti,14.2167240887,3.02037950541,1,11,12
auggie,14.2025408566,4.08447017298,0,9,9
cgmontage,14.1812752256,4.15731699682,0,7,7
spazer,14.1145332278,3.10893647875,2,8,10
primefry,14.0930491812,3.0680817434,1,11,12
chacalaca88,14.0592887048,4.51171095119,0,6,6
bluey,14.0117268891,3.06815159845,2,10,12
y-tho,13.9934117332,4.88613735487,0,4,4
godofgrunts,13.9879099063,4.75561667942,0,7,7
burglor,13.9872891528,5.36870827097,0,4,4
hiv+,13.901826859,3.40182863074,1,8,9
myk,13.8626267077,5.36647171848,0,4,4
edgar allen pwn,13.8498416915,3.61761893978,1,10,11
telemonic,13.8427612848,5.11134591887,0,4,4
adamant,13.8244907836,5.26140974939,0,4,4
turtle,13.8129463219,4.39861893127,0,8,8
road-rage 64,13.7972831314,4.50223761078,0,6,6
bort,13.7681891636,4.06888541833,0,6,6
mf space,13.7084587926,4.73300019529,0,5,5
frapple_apple,13.7072672132,3.5086807716,1,7,8
rich,13.7007553579,4.9421460901,0,5,5
kronk!,13.6548925585,2.63871800024,2,18,20
scruff,13.6047576847,4.97808352464,0,6,6
mattc,13.5965078034,4.33398641399,0,5,5
lotionhole,13.5949478641,4.41556199518,0,6,6
mike4real,13.5911308271,3.33630527428,2,10,12
cat,13.5100554597,4.71980783012,0,5,5
hashi,13.491138569,2.43757518079,3,22,25
whiz kid,13.41632192,5.16801688047,0,4,4
blanco mano,13.4015177081,4.59893174621,0,5,5
heavy,13.3691160215,4.15942732012,0,5,5
scaryman,13.3668329574,4.32703399476,0,6,6
ben,13.3642019626,2.55075429629,2,16,18
neff,13.2865074669,5.55475005027,0,3,3
woof,13.2208606529,5.01298816141,0,5,5
mop,13.2063100722,3.28238523028,1,8,9
hwatts,13.1973781638,3.67744288475,0,13,13
dabs?,13.1728637698,4.09408740709,0,9,9
fitzy,13.1337384931,4.51865731052,0,4,4
gato,13.0901308656,4.41738383503,0,5,5
majinchu,13.0588382432,5.04319913532,0,4,4
greatwhitebuffalo,13.0277627792,4.6640516113,0,3,3
sour,13.0156446877,3.75426160617,0,10,10
oldiz,12.9634733817,5.08418225991,0,4,4
mormonjo,12.9391459859,4.56753231468,0,4,4
brother quang,12.9172139243,3.33673077902,2,8,10
weslec,12.9045096387,3.75029668801,0,8,8
lotus,12.888253364,5.47578422091,0,2,2
zorro253,12.8864621892,3.25318774316,1,10,11
monica,12.8102829405,4.5799332374,0,5,5
boogie!,12.7715666219,3.01420642058,1,14,15
nardwell,12.754403204,1.88523679832,6,45,51
rokd,12.6929834792,4.62639676455,0,4,4
twisty,12.683355433,2.58166444143,2,27,29
jofis,12.5470943055,3.58190986131,1,7,8
jimbot,12.5261010076,4.50079562529,0,7,7
phynque,12.4833235843,3.45498312188,0,12,12
gasmask,12.432596719,3.91514739088,0,8,8
moog,12.3864619126,3.18321907778,1,8,9
fabulousboy,12.3095847926,3.83563857941,0,9,9
tyler_stewart8,12.293589741,3.60496811518,1,6,7
terrible fate,12.2566983961,3.51180131019,1,12,13
putpasswordhere,12.2385723394,4.50306841539,0,8,8
neph_girl,12.1307143638,2.95516551885,1,14,15
ohb-noa,12.1158006734,4.13749540054,0,8,8
doublej,12.0931975724,3.55959051751,0,13,13
lolitaz667,12.0486960961,3.33057581904,1,8,9
sven,11.8341647271,2.64269510401,2,14,16
b rod,11.8005733254,5.01593847821,0,5,5
thundergarms,11.7853251443,3.29611576982,1,7,8
syph,11.7415994761,3.63585764552,0,9,9
jame,11.7146461005,3.36827295174,1,10,11
little things,11.6936144968,4.00683188968,0,7,7
mambo,11.6591429575,4.82509014485,0,4,4
nicklebackair,11.6372616398,3.5073165683,0,9,9
whitezebra,11.5545209024,3.59182751304,0,10,10
microwaved hotdogs,11.4336936147,4.10903044853,0,10,10
half man,11.4287838487,3.67478661086,0,8,8
baloo,11.3147819579,4.48448113389,0,5,5
t3rquoise,11.3123747726,3.83187299535,0,10,10
ranger,11.2432877403,4.07539048847,0,10,10
mello,11.0912086449,3.19857462882,1,16,17
reject,11.0853741373,2.51394492071,1,27,28
qwesseccssffdy,10.9559607076,4.94094106547,0,4,4
stevenballoons,10.8877218285,3.14269907785,1,9,10
jerry bean,10.7657719739,5.18257533975,0,2,2
baedough07,10.6471654546,4.11673382435,0,5,5
2p,10.5406646637,3.31833887148,0,16,16
knothy,10.5163048756,3.62891928379,0,12,12
ceec,10.3726522075,3.40091759064,1,10,11
brizzles,10.229046821,4.00431413544,0,8,8
copper,10.2040602304,3.75311478863,0,8,8
lloyd.,10.1877227895,3.63995997324,0,9,9
