player,mu,sigma,wins,losses,sets
hwats,9.89386211772,3.56119631123,0,12,12
yung duccboii,9.84706782931,3.96270931994,0,7,7
seaniemaster,9.64580891533,3.7971690714,0,8,8
macrado,9.53043073524,3.41245129411,0,13,13
gluu,9.48512551935,3.89013074451,0,6,6
jet fuel,9.32846776898,2.9014972597,1,16,17
soggy biscuit,9.12203604566,3.39620644459,0,9,9
seaweed dragon,8.9854908272,3.70450733786,0,8,8
golfclubninja,8.64853549655,2.81158507765,1,28,29
archduke,7.49560862507,3.60769807975,0,9,9
superboomfan,51.1055328666,1.18756128332,192,11,203
alvin,49.0718980174,1.20487631529,87,11,98
fukurou,48.7632312317,1.57789006848,42,4,46
wizzrobe,46.2857315212,1.07735295595,109,23,132
kysk,46.2593706764,2.03443376375,18,4,22
mariguas,46.2425560549,1.10091608901,102,22,124
kurabba,46.057813933,1.93210957772,20,4,24
wario,46.0396284856,2.28854387141,18,3,21
wangera,45.3460951838,1.69764162814,29,7,36
dext3r,45.0365319455,1.15375492485,77,20,97
kerokeroppi,44.9380149555,1.07784088388,88,25,113
isai,44.6950957259,1.26008917269,68,15,83
tacos,44.2007782963,1.19969077718,80,21,101
zero,44.0831221109,1.10997786032,92,22,114
fox,43.4730158267,1.29718227137,56,12,68
prince,43.4630695233,2.15601034863,17,4,21
joshi,42.6841243193,1.84865428248,21,5,26
tr3gthez,42.5794036373,1.21517161515,63,19,82
brody,42.5179177684,0.950689733176,185,57,242
lowww,42.1618367344,1.35167601002,53,11,64
gyaki,41.9782896539,2.63934253874,11,2,13
revan,41.9525050245,1.16360425332,65,22,87
hiyo,41.672965166,2.6930787393,9,2,11
yu-kun,41.6287847817,3.0522751637,5,2,7
taimai,41.1999927343,2.99721885058,5,2,7
stranded,40.8606134009,1.21458331472,63,19,82
dtan,40.1623494631,1.50211583622,27,12,39
lord narwhal,40.1585319562,1.18197075234,60,20,80
robert,40.0195271528,1.31101314792,44,15,59
bloodpeach,39.9294001492,3.1970330408,9,2,11
jaimehr,39.8009042091,1.25790511214,48,21,69
firo,39.6524797744,1.46142264895,35,14,49
cobr,39.5459182616,1.29722156835,45,18,63
hammerheart,39.1406296267,1.26090578525,55,18,73
kort,39.1346318868,1.73577220723,26,10,36
shalaka,38.9862191115,1.67039715088,27,11,38
derek #squats,38.8419594233,2.13064325542,11,5,16
banze,38.5738127634,2.4543127245,11,5,16
czar,38.5665852899,1.68438109284,28,9,37
ctg,38.4758012966,1.02815225324,94,36,130
heropie,38.4548680135,1.87880320634,20,7,27
hero pie,38.3613652462,1.9729778604,18,8,26
kd3,38.3349265269,1.05835758151,83,27,110
fireblaster,38.1682902215,0.939071923813,138,53,191
star king,38.1116826845,1.26399348832,50,20,70
nacl,38.0518515457,1.35202902288,43,18,61
handsometom,37.7394136752,2.02998447138,14,8,22
kimimaru,37.6361529336,1.55908070373,29,14,43
clubbadubba,37.6289968351,1.57102447963,30,12,42
combo blaze,37.5593640305,1.45758815222,37,16,53
manjaro,37.5545098591,3.1458414734,8,3,11
sheermadness,37.4573848299,1.88698523726,18,8,26
barksanchez,37.3206669355,3.61054700609,4,2,6
bonobono,36.9965762617,3.29635424318,5,2,7
janitor,36.7562535601,1.30451423483,51,21,72
janco,36.7080779205,1.73617750104,21,12,33
nta,36.6484519376,1.72734676255,23,10,33
kyle tree,36.5218539224,1.91028076577,18,10,28
marbles,36.4470942387,1.1361530774,60,26,86
shears,36.3532845703,0.944242528311,140,62,202
ybombb,36.2272557373,2.22463913331,12,8,20
loto,36.187078507,1.19707452803,46,23,69
stevie g,36.1490673455,1.37034289227,40,14,54
darkhorse,36.1465239363,0.947296169106,101,52,153
skg,36.0871628026,1.27555930328,36,18,54
finio,36.0512718067,1.24313272979,44,21,65
nintendude,35.8123618888,1.19789116888,53,29,82
yunque,35.8008450621,1.46694939048,31,15,46
horbie,35.5069315925,1.1659636749,61,29,90
roman,35.45936235,1.51230154408,34,16,50
greginator,35.4397280073,2.78222913209,7,4,11
lorenzo,35.3271183873,1.6583464125,24,11,35
hydra,35.3169370284,1.70472126243,23,11,34
nothing,35.0178450691,2.24135050833,14,6,20
fumbles,35.0143772804,2.14878214998,14,6,20
sotoh,34.8944193667,1.46101401042,33,19,52
blondekid,34.887142529,1.72443289593,22,11,33
purple circle,34.7977143592,2.83709331698,12,4,16
jason,34.796847604,1.63772369502,26,12,38
jose,34.6998032055,2.58474290122,8,4,12
amida,34.6764205455,2.26888997825,12,7,19
vinsanity,34.5764027244,1.87137146065,16,8,24
hotline,34.5417375569,1.66398013869,21,11,32
fray,34.4612917025,3.36124063153,3,3,6
letsgo,34.4116268855,1.82872773014,19,12,31
$$$ jim $$$,34.3934646682,1.43549477498,32,16,48
daniel,34.3537374454,1.62842558474,21,14,35
jam,34.328963468,2.58609793143,8,5,13
dark gentleman,34.2931497634,1.16920946864,50,26,76
supa,34.2788369991,1.60166852308,22,13,35
antwon420,34.0899419121,1.85218592062,16,9,25
sax,34.0823448889,2.41080137426,10,5,15
gravyfingers,34.0728829154,2.04713470535,17,8,25
yobo,34.0576949285,1.12714460962,54,32,86
freean,33.8867011664,1.32222259633,37,21,58
connor,33.8863928495,1.93220147995,20,10,30
the ki of chaos,33.8799312428,5.88936153694,1,0,1
eg,33.8634704438,1.47535500343,28,16,44
james3927,33.6200282613,2.52592228064,11,4,15
madrush,33.5852871063,1.02956985901,66,46,112
masterhandjob,33.5476082523,1.1119502198,54,30,84
wookiee,33.5141406024,1.33227892102,37,22,59
hipstur,33.5138106818,1.22295131673,51,25,76
b link,33.4210302855,3.4233122782,4,3,7
time machine,33.4122095958,1.85147504323,19,10,29
fruity,33.3635945136,3.52784885295,5,2,7
pugs,33.3410763998,1.26120790035,35,24,59
butt solo,33.3123151592,3.84667530793,3,3,6
schickler,33.308578493,2.59022237912,9,4,13
satan [turner],33.3043093714,3.29711714346,4,3,7
fishaman p,33.2740791831,2.40097978322,9,6,15
sextc,33.246150799,1.62329321882,21,16,37
raychu,33.2434810808,1.24332626914,47,22,69
dajjal,33.2426376083,1.71507081114,22,13,35
facechew,33.1235160338,3.94508944253,5,2,7
timemachine,33.0160699354,1.57441197546,25,16,41
sedda,33.0047671976,1.35576640212,36,20,56
near,33.0036686241,2.16030434311,12,8,20
zeppelin,32.9315705413,3.10089909277,5,3,8
smash jesus,32.8809480736,2.29370933631,14,6,20
monte,32.87297052,1.9220423217,15,6,21
bo,32.8691260641,2.00108017977,14,9,23
indefa,32.8544720606,1.93564711274,19,9,28
sunnyb,32.7879977522,3.56449745895,4,3,7
the protagonist,32.7460247355,1.16486367899,50,32,82
andykins,32.6824133926,1.53824878655,25,13,38
mojomonkey,32.668718417,2.20152062936,12,7,19
dr. grin,32.647496333,1.88948332846,17,12,29
mr.sir,32.6336061013,1.1164637074,55,35,90
cyoonit,32.5903422027,1.87074535026,14,10,24
preston,32.5827774305,1.33922960457,38,22,60
nickelbackstreetboy,32.552020885,3.54628299533,4,2,6
dogs_johnson,32.5467941005,1.24391787775,42,25,67
shihman,32.5415073388,1.30608764899,42,25,67
j.moosh,32.5025598436,2.80562800969,9,4,13
the big d,32.407643044,4.09802043876,4,2,6
poobearninja,32.4037778794,2.84303906931,9,4,13
stonefallow,32.392499565,3.49415537303,6,4,10
jay_mute$,32.3324217084,1.68486953222,20,12,32
th3kuzinator,32.2195835115,3.33454023191,6,4,10
dishier wand,32.1706993681,1.38569230504,31,23,54
subtle,32.1019386321,2.33345274897,13,9,22
the dark gentleman,32.0509317121,3.552146823,4,3,7
gildo,32.0414950746,1.54982389562,27,14,41
eggmode,32.0055547294,2.10327727268,13,11,24
b0n,31.9822767556,3.9641478883,4,2,6
jay-r,31.9701365795,1.52848810887,26,15,41
weedwack,31.9546126968,1.56940035303,21,17,38
knitephox,31.9450771041,2.41855201508,10,7,17
dogg,31.9213758108,2.58725412792,8,6,14
snorlax,31.9182074651,1.95240588733,15,10,25
ken,31.8110244458,5.40169263758,2,1,3
elel,31.7975663538,1.54200283707,28,18,46
spongy,31.7644216717,1.25627166219,39,22,61
bp,31.6493478131,2.20208118419,11,7,18
spark,31.6297182442,2.75594821915,7,4,11
battlecow,31.5939869488,3.4016171486,4,3,7
qapples,31.5922662815,1.32848062633,32,26,58
socrates,31.5914453044,2.51312156314,7,6,13
bard,31.5738710282,1.27437578416,35,28,63
tank,31.5671868427,2.47723416978,10,7,17
d35,31.5461122005,1.50196373939,26,18,44
nattybroh,31.5369189623,2.65377269796,9,4,13
kirbstomper,31.5188344006,3.86445858352,4,3,7
moosh_da_moosh,31.4932053722,2.0912875912,14,8,22
commander,31.219157037,4.42278572814,3,2,5
dr. lampy,31.2168873146,1.62099199426,18,12,30
a to the z,31.2052346468,2.11350234695,11,10,21
josephzander,31.1977877538,3.43202608064,5,3,8
q!,31.1857353004,1.28632978351,38,28,66
komotonoto,31.1498147496,2.27974119836,11,7,18
g0d,31.1403348642,4.50048660197,2,2,4
rossi,31.1312028168,4.20548682927,3,2,5
pete,31.0990824104,3.62685915722,4,3,7
deathcpo,31.0664956994,1.21609603432,39,30,69
tyhiggz,31.0457098765,1.18504564975,43,30,73
saltsizzle,30.9854256545,1.73386994279,17,13,30
studstill,30.9310670975,3.00777583832,7,4,11
ivor,30.8866197892,4.09947611008,3,2,5
se√±orhen10r,30.8806362237,2.76259119025,7,5,12
kaz,30.8737541566,1.15514620723,51,31,82
jimmy joe,30.8583116233,1.08019358459,46,45,91
fck vwls,30.8183836789,2.26392329013,10,11,21
shanks,30.8108401106,2.93696326187,6,5,11
gunnermaniac,30.7953626406,1.97520609142,12,10,22
miniohh!,30.7335005374,1.64722539234,20,13,33
tot,30.6935093983,3.09561865676,7,6,13
inukem,30.6870299912,3.45386431702,4,2,6
paco,30.6533823007,1.32276645896,34,26,60
a$,30.6290405199,2.35956476871,10,6,16
dubs,30.5848088535,3.18209149888,7,4,11
limesoda,30.5841021641,1.65932893949,21,15,36
rusty,30.5561408096,1.22638535683,34,28,62
zeozen,30.5279783669,3.96968691535,4,3,7
jamjar,30.4662104094,1.08696158305,53,43,96
bowl,30.4260427334,1.64047773636,19,17,36
scoback,30.4233289289,2.4492886836,9,9,18
joker,30.4151469058,4.03163717998,2,3,5
skyfire,30.4061609588,1.82735926306,14,12,26
bread,30.3878024737,1.74158774214,17,15,32
natty,30.3735661457,2.78589603033,7,4,11
korobeniki,30.1583408521,1.27585089696,38,28,66
the (.)(.),30.1406137426,2.39528242586,9,7,16
american patriot,30.1314011221,2.34664640591,8,5,13
captain l,30.1240619931,1.89474129708,14,15,29
pizza jokes,30.0637174295,3.52319221168,3,3,6
captain fabulous,30.055358528,1.59797546781,23,18,41
rith,30.0135657531,3.90958200199,3,3,6
emptyw,30.0122835693,2.67407347092,8,5,13
llcstoism,29.9759611842,1.72259791694,17,15,32
yoleo,29.9592761316,1.93597100695,13,12,25
fancy,29.9518204603,4.24685236426,3,2,5
nyx,29.9441216803,3.21748151746,5,4,9
mokkori,29.9221620874,4.18659466566,3,2,5
onski,29.8844752825,1.49985187304,25,24,49
moogle,29.8328805413,4.33168728203,3,2,5
bt,29.8308131473,2.17072406605,9,8,17
b33f,29.8049180069,1.35431970172,30,21,51
v,29.7846127329,1.37508840749,29,25,54
heny935,29.7663175994,3.94718579012,4,2,6
olbus,29.6874856904,3.96253409654,4,2,6
bert,29.6713762171,4.01249424039,4,3,7
daniels,29.6602371902,1.47113487489,27,20,47
spamus,29.6555808028,1.30785260127,30,28,58
crockett,29.6464721338,2.44693878477,8,6,14
razz,29.6341947829,1.04279875145,61,46,107
lob,29.6109466827,2.58722832147,7,5,12
mr. wang,29.6048887164,4.10245695982,4,2,6
reptar,29.5565004228,1.29843283905,34,27,61
sheick,29.5503377062,3.1366967213,6,5,11
m-angry,29.5496663743,3.08295802478,6,4,10
pewpewu,29.5103515998,3.04433830289,8,5,13
quitrage,29.4884207262,3.26677177273,5,4,9
wincancel,29.4820093493,2.66452122692,8,6,14
umbra,29.4752212703,3.27260665752,6,4,10
the american patriot,29.4373245494,4.21048447834,4,2,6
piratetrips,29.4211027898,2.81001356653,7,4,11
dublat,29.39583202,7.17147558733,1,0,1
sampai,29.39583202,7.17147558733,1,0,1
blue,29.39583202,7.17147558733,1,0,1
charky,29.39583202,7.17147558733,1,0,1
sarge,29.39583202,7.17147558733,1,0,1
stingers,29.39583202,7.17147558733,1,0,1
rocket,29.3614613132,1.33901660748,28,25,53
greeno,29.357804193,1.65833849903,23,15,38
annex,29.3346910167,1.80605696921,18,14,32
jxc,29.3340550887,2.11537779267,11,8,19
newbtube,29.3318651717,2.71959325589,5,5,10
logic,29.3268430468,2.09986162906,10,8,18
thord's bro,29.3091416488,3.13382029652,5,4,9
natendo,29.2779462615,2.06421808493,12,8,20
0prah,29.2721865104,2.85005726794,6,6,12
t-beau,29.2682591448,2.79046861375,7,6,13
reefybeefy,29.2634648284,1.82573149834,14,13,27
morino,29.2260895886,3.85461294267,3,3,6
dizzle,29.2013104974,1.37555525391,26,27,53
bigfish,29.1396074192,2.72465171083,6,5,11
aerosheep,29.1116346005,3.97470040886,4,3,7
mustard tiger,29.0995072215,3.32198432043,6,4,10
repsguy,29.0773983641,4.87212481094,1,1,2
nesskhalifa,29.0631895571,1.74918674226,16,16,32
toro,29.0095603006,4.38928209674,3,2,5
touque,28.9823537595,4.27259275633,3,2,5
kyle,28.9737097117,2.56526572052,8,6,14
chet dunskies,28.9700412078,3.43378118418,5,3,8
duffman,28.9576994666,4.44491789939,3,2,5
allgreen,28.9262837928,2.4466699084,7,6,13
gt,28.9009669293,0.920469237615,90,79,169
king lumsy,28.8944027651,2.65458897895,7,6,13
fil,28.8784680943,1.31977395414,29,30,59
broly,28.8374272901,4.38916703232,3,2,5
backes,28.7762510033,4.48579929701,2,3,5
elvis,28.7587498633,4.26553689379,3,2,5
pathall,28.7271970168,4.69344711303,2,2,4
a la carte,28.6131211007,3.55538815759,5,4,9
kelvinheit,28.5799572221,1.43540746498,29,19,48
bon,28.5610273459,2.76799682546,7,8,15
breakthrough,28.5495037958,1.94526483056,13,14,27
birdlordmasterbeak,28.5429251864,7.1211258753,1,0,1
fenrir,28.4965137765,4.6606806447,2,2,4
zuko,28.4805152137,1.94133631463,16,14,30
cam,28.4590758304,1.97966442819,10,12,22
yrn,28.4218143738,2.08031089314,10,10,20
epic!,28.4162696831,3.01696808576,6,4,10
darkneon,28.4157960148,4.4070657674,3,2,5
purtle,28.4133628411,1.96266880073,12,12,24
fenlet,28.3266261106,4.74669751974,2,2,4
phut,28.3223415456,3.99197197983,3,3,6
tvdonk,28.3203937299,4.45958674045,3,2,5
ibc,28.3130419186,3.36281447405,4,4,8
smurf,28.3113334752,1.26726476975,41,32,73
coin chaser,28.2990279648,4.40912520839,3,2,5
tonester,28.2573544168,2.049668317,14,10,24
slappypoopy,28.2446073678,1.58437238741,22,18,40
blaise,28.2055181803,4.52219949795,3,2,5
peasantloaf,28.1958652619,4.26248928484,3,2,5
bloogo,28.1925705442,1.14638869727,39,37,76
jsmirk,28.1818042146,1.51209009885,26,22,48
autobaun,28.1529055021,4.53845634446,3,2,5
bacorn,28.1436498056,2.47567422153,9,9,18
nattyb,28.1340321176,4.41412338,3,2,5
cody,28.1035492203,4.80174516421,3,2,5
toronto joe,28.0996945701,4.53051547838,3,2,5
batterybird,28.0646892936,4.53376969681,3,2,5
kraines,28.0154055579,4.8746850721,3,1,4
sebula4,27.9711233548,4.45140829467,3,2,5
mr. slimey,27.8861676951,4.73510882063,2,2,4
box765,27.8777801337,1.38265151763,21,25,46
anotherish,27.8480172074,4.74511802982,3,2,5
enneielle,27.8195884603,3.84402021199,3,3,6
therm,27.7964252727,3.64508987182,4,4,8
taiko,27.7901482209,2.48686928205,8,9,17
kriskringle,27.7882704409,2.88313068568,6,5,11
dragoniota,27.7660977373,4.48734501111,3,2,5
professor_wizard,27.7559701921,1.42823523422,29,22,51
xor,27.7306959177,4.55622523955,3,2,5
automatic,27.7247749096,1.63934125027,16,19,35
dam_tewton,27.707652697,2.09780480312,11,12,23
zyrg,27.6875599983,3.14537362783,5,4,9
maliki,27.6870018731,2.07951345498,13,11,24
xyk,27.6764184763,4.4512066855,4,2,6
bamster,27.668461639,2.96139186275,6,6,12
waxy:joe,27.6618495927,1.34260491685,24,25,49
rishi,27.6480759686,5.64916336094,2,2,4
velocity jones,27.6309923783,1.21580160392,34,34,68
kabal,27.625076721,3.87756274923,4,3,7
marlwolfe,27.552619447,3.82671112369,3,3,6
quickcav,27.55040182,3.25546867637,5,3,8
shake,27.5443348534,2.75054174948,6,7,13
t0mmii,27.5268971516,4.50511998972,3,2,5
hack,27.5218065039,1.65830546659,19,17,36
duff man,27.5116062286,1.92053831654,12,14,26
viberant,27.4894048031,2.45607221512,8,7,15
maniac379,27.421806831,1.31521033389,31,33,64
r6=s2=(sr)2=1>,27.395375224,3.74718090608,3,2,5
darv,27.3866213461,2.29710895067,9,10,19
my buddy mike,27.3630733325,5.18234526133,2,2,4
fake,27.3096951608,3.34941238027,4,4,8
toa,27.3054577905,5.42809906009,2,2,4
beans,27.2937512222,1.7094262793,18,15,33
dpb,27.2936032517,4.60076381324,3,2,5
ern,27.2752491302,4.52152801546,3,2,5
1000,27.2336915033,5.26256748611,2,2,4
maze,27.1756611728,4.92031184378,2,2,4
ringedge,27.1690228687,1.57512844251,20,16,36
p21/c,27.1645039668,1.87813694603,13,15,28
okuser,27.1031706345,2.21229932332,8,10,18
pizza,27.0801844935,1.51997297711,23,25,48
meromorph,27.0514008875,5.01281748756,2,2,4
freddy cougar,27.0208363255,5.4314485912,2,2,4
sunflower,26.9758919682,1.3795042366,25,28,53
jnatty,26.9481395276,3.09711094194,6,6,12
vudujin,26.9460054325,4.79897904172,2,2,4
mr.watchandlearn,26.8453200038,5.13273670901,2,2,4
the yid,26.8245724339,1.14896201788,42,45,87
vanddar,26.812335727,4.90847115312,2,2,4
big dick damage,26.7843113594,3.23147890287,4,4,8
cam2,26.767989254,2.33964641836,7,8,15
kaladin,26.7588062893,4.84757461904,2,2,4
cwic-beam,26.7549085525,1.92991456466,14,14,28
flanders,26.7241566741,2.78540384013,7,5,12
walkrofsky,26.7044085248,1.76019269165,12,17,29
fudgeball,26.6801323654,4.1606982305,2,2,4
no~m,26.6773616482,2.79234503699,7,6,13
rizner,26.669021182,1.9235980898,14,14,28
maps,26.6575007006,1.50271928477,20,21,41
blue lantern,26.6380746027,4.9091984619,2,2,4
shyboy,26.6343030405,4.82060840724,2,2,4
sav,26.6043611999,2.34370366766,8,7,15
el man,26.5763483609,2.59648839011,7,5,12
synth,26.5707186862,4.42243348254,2,2,4
salami,26.5617394448,3.05667432232,6,5,11
hoofy,26.5385910123,1.55124200925,23,22,45
oh thomas,26.4592623818,4.30998449577,3,3,6
dad,26.4564978853,2.89163264799,7,5,12
nalgas,26.4324148357,4.52154689818,3,2,5
whitejesus,26.4318952962,1.23402453406,30,36,66
mando,26.4268680956,2.17358681471,10,13,23
k rool,26.4096173074,1.76060426042,13,16,29
killahertz,26.3643937395,3.04031012948,5,6,11
gooby,26.317433934,2.78089717676,6,7,13
stonehaus,26.3144683052,4.85649340991,3,2,5
thomdore,26.289995851,5.07871297773,2,2,4
white,26.2127601873,4.45860810546,2,3,5
hhhhhhhhhhhhhhh,26.1805605948,4.94442759964,2,2,4
king funk,26.1531703096,4.11561284696,2,3,5
cam1,26.1478490335,2.52356145774,8,7,15
hypa,26.1258403992,4.79492866376,2,2,4
stew,26.1059189503,1.3016177976,32,34,66
droc,26.0772343118,1.36946622414,24,29,53
shishkabobs5,26.0718708003,5.37780397789,2,2,4
flatvi,26.0322107286,4.22537085681,3,3,6
ham,25.9704892652,1.83781070838,13,16,29
toxic,25.961974736,1.89147305652,13,11,24
boomalready1,25.9453830841,3.75152378119,3,4,7
superderekfan,25.9414836123,4.68834676926,2,2,4
bringdaruckus312,25.8961482234,4.91181907561,2,2,4
mortech,25.8668599499,1.68431360567,17,19,36
bigbeaver,25.8296121002,1.30512328414,26,34,60
collin,25.8001956959,2.28152815393,9,9,18
bunz,25.7855310581,2.19737869185,11,15,26
cmull,25.7646158657,3.4504720971,3,4,7
hoofydough,25.7113062928,4.91600928402,2,2,4
traiman,25.670815147,1.95899638384,11,14,25
baby legs,25.6680584228,2.56436753402,7,7,14
lookalike,25.6377991163,3.68278876889,4,4,8
webwipe,25.6036172457,3.38413278101,3,4,7
ace,25.6024426035,1.60131136611,16,21,37
le_vinny,25.5955168448,3.31565360657,4,4,8
z-rex,25.5906930944,2.71191325779,5,8,13
blmb,25.5873397993,4.74757354175,2,2,4
meerkat,25.5830177788,2.38833218394,9,10,19
komodoninja,25.5772038605,2.70194367279,8,5,13
scratch,25.576816208,1.86902176925,13,16,29
j9d2,25.5678331018,4.26488499498,2,2,4
tbq,25.5638398329,3.35544412538,4,4,8
sebula,25.5637552041,1.2647675873,29,35,64
chuck lubs,25.5606773425,5.02116683742,2,2,4
hariballz,25.5320289049,3.41696308649,4,4,8
kirbyrocket,25.5238244992,4.31454511331,3,2,5
prime,25.5135885007,1.67198093546,17,17,34
funkykong,25.5050742126,4.87107097566,2,2,4
justin,25.4595172932,2.69272657888,7,6,13
mixxedvegetables,25.4501743805,4.70204997659,2,2,4
ttt,25.4358600874,3.01167598573,3,6,9
jlo,25.4120316069,4.81805105085,2,2,4
snowstorm,25.3934923152,4.93156978565,2,2,4
t brett,25.3671626614,3.85884397536,3,4,7
starchild,25.3611312572,2.95232769534,6,6,12
nasian,25.3404237394,5.74907458247,1,1,2
griffith,25.3329181762,1.38342709082,22,28,50
therapture_,25.3258278266,5.13054155253,2,2,4
salt,25.2941591503,4.96321040971,2,2,4
purple fox,25.2890644797,4.58709452422,2,2,4
sunvulcan,25.2834508102,1.5442700091,21,19,40
wazzberry,25.2821512309,4.73421942984,2,2,4
cortese187,25.2734327832,4.80713072026,2,2,4
swiftbass,25.2622368269,4.89216411198,2,2,4
h2o,25.2593669871,4.85995252983,2,2,4
zhu,25.2570917719,5.15198224649,1,2,3
klms,25.2540556461,4.9265753216,2,2,4
log,25.2440158213,2.9511744054,4,6,10
zbl_mystic,25.2424725068,5.22739906805,1,2,3
blisstex,25.2319024376,2.95989520789,6,7,13
pandemonium,25.220578387,4.55214797812,2,2,4
giraphe,25.1767537615,4.8547062007,2,2,4
wowzers,25.1586957156,4.68073409761,2,2,4
slappymcnutz,25.1407146885,1.8491429341,11,18,29
doughnut,25.1359428401,4.90347605729,2,2,4
qubit,25.1257493202,4.91426923128,2,2,4
karlthemarx,25.1124033326,4.8206721687,2,2,4
leavescat,25.0993709433,3.5385561854,4,4,8
poptartplug,25.0826285291,5.11818158289,2,2,4
iheartqueso,25.080069247,2.64976379324,8,9,17
damp,25.0462356422,4.82420329543,2,2,4
notlightningrunner,25.0432425227,4.65308130371,2,2,4
tom bombadil,25.031822087,3.2760726644,4,5,9
beguiler,25.0181002617,5.04179208223,2,2,4
measthebeast,25.0150528665,2.09151899488,9,10,19
bird-dawg,25.0,8.33333333333,0,0,0
hans_mawell,25.0,8.33333333333,0,0,0
redeagle2000,25.0,8.33333333333,0,0,0
chai,25.0,8.33333333333,0,0,0
adubz,25.0,8.33333333333,0,0,0
sd master,25.0,8.33333333333,0,0,0
urpasmash,25.0,8.33333333333,0,0,0
spicky,25.0,8.33333333333,0,0,0
sussebass,25.0,8.33333333333,0,0,0
falln,25.0,8.33333333333,0,0,0
duckpimp,25.0,8.33333333333,0,0,0
name,25.0,8.33333333333,0,0,0
lukem,25.0,8.33333333333,0,0,0
marfslayer 3000,25.0,8.33333333333,0,0,0
spade,25.0,8.33333333333,0,0,0
goomah,25.0,8.33333333333,0,0,0
mimi,25.0,8.33333333333,0,0,0
dunos_,25.0,8.33333333333,0,0,0
coldo,25.0,8.33333333333,0,0,0
reb,25.0,8.33333333333,0,0,0
rudedude,25.0,8.33333333333,0,0,0
werewyatt,25.0,8.33333333333,0,0,0
masterofzoroark,25.0,8.33333333333,0,0,0
madguy,25.0,8.33333333333,0,0,0
oljace,25.0,8.33333333333,0,0,0
flat nat,25.0,8.33333333333,0,0,0
mickeyrat,25.0,8.33333333333,0,0,0
flash,25.0,8.33333333333,0,0,0
sheen,25.0,8.33333333333,0,0,0
ozymandias,25.0,8.33333333333,0,0,0
jarl,25.0,8.33333333333,0,0,0
bund,25.0,8.33333333333,0,0,0
thac0,25.0,8.33333333333,0,0,0
hail_sagan,25.0,8.33333333333,0,0,0
fireberts,25.0,8.33333333333,0,0,0
voidstar,25.0,8.33333333333,0,0,0
4sk,25.0,8.33333333333,0,0,0
[stg] overload,25.0,8.33333333333,0,0,0
da_bear,25.0,8.33333333333,0,0,0
bus,25.0,8.33333333333,0,0,0
pilot,25.0,8.33333333333,0,0,0
puddn,25.0,8.33333333333,0,0,0
mahie,25.0,8.33333333333,0,0,0
sharktoast,25.0,8.33333333333,0,0,0
the cfb,25.0,8.33333333333,0,0,0
brentosfreshness,25.0,8.33333333333,0,0,0
fractal,25.0,8.33333333333,0,0,0
juno,25.0,8.33333333333,0,0,0
birdybirds,25.0,8.33333333333,0,0,0
pat,25.0,8.33333333333,0,0,0
sambo,25.0,8.33333333333,0,0,0
magitech,25.0,8.33333333333,0,0,0
djltheescapade,25.0,8.33333333333,0,0,0
acestarthe3rd,25.0,8.33333333333,0,0,0
benb,25.0,8.33333333333,0,0,0
tdx,25.0,8.33333333333,0,0,0
sleeh,25.0,8.33333333333,0,0,0
sabo,25.0,8.33333333333,0,0,0
emon,25.0,8.33333333333,0,0,0
monk,25.0,8.33333333333,0,0,0
link,25.0,8.33333333333,0,0,0
nokto,25.0,8.33333333333,0,0,0
paul d,25.0,8.33333333333,0,0,0
branchan,25.0,8.33333333333,0,0,0
jeremy,25.0,8.33333333333,0,0,0
aperture,25.0,8.33333333333,0,0,0
deep dimples,25.0,8.33333333333,0,0,0
price,25.0,8.33333333333,0,0,0
vio,25.0,8.33333333333,0,0,0
mouse,25.0,8.33333333333,0,0,0
rice,25.0,8.33333333333,0,0,0
magnus combosen,25.0,8.33333333333,0,0,0
moft,25.0,8.33333333333,0,0,0
neverpullout,25.0,8.33333333333,0,0,0
locamash,25.0,8.33333333333,0,0,0
tweli,25.0,8.33333333333,0,0,0
royeric,25.0,8.33333333333,0,0,0
spaff,25.0,8.33333333333,0,0,0
big d [hamiel],25.0,8.33333333333,0,0,0
chewy,25.0,8.33333333333,0,0,0
awesomethesauce,25.0,8.33333333333,0,0,0
ubll black mage,25.0,8.33333333333,0,0,0
stephanie,25.0,8.33333333333,0,0,0
king lui,25.0,8.33333333333,0,0,0
ferrero64,25.0,8.33333333333,0,0,0
mistertizye,25.0,8.33333333333,0,0,0
snazzy,25.0,8.33333333333,0,0,0
imperium,25.0,8.33333333333,0,0,0
patty-wagon,25.0,8.33333333333,0,0,0
redribb0n,25.0,8.33333333333,0,0,0
malkasaur,25.0,8.33333333333,0,0,0
dobermen?,25.0,8.33333333333,0,0,0
astumpyzombie,25.0,8.33333333333,0,0,0
dezno,25.0,8.33333333333,0,0,0
cr0ak,25.0,8.33333333333,0,0,0
sylveonbae,25.0,8.33333333333,0,0,0
god,25.0,8.33333333333,0,0,0
rf!,25.0,8.33333333333,0,0,0
hyperbole,25.0,8.33333333333,0,0,0
squallette,25.0,8.33333333333,0,0,0
phex,25.0,8.33333333333,0,0,0
johnnyfight,25.0,8.33333333333,0,0,0
foxnard,25.0,8.33333333333,0,0,0
zane,25.0,8.33333333333,0,0,0
miken,25.0,8.33333333333,0,0,0
electricgazelle,25.0,8.33333333333,0,0,0
bronze_sun,25.0,8.33333333333,0,0,0
dude,25.0,8.33333333333,0,0,0
4eyez95,25.0,8.33333333333,0,0,0
smashlopez64,25.0,8.33333333333,0,0,0
purplefox,25.0,8.33333333333,0,0,0
the amazing busterino,25.0,8.33333333333,0,0,0
jobook,25.0,8.33333333333,0,0,0
astumpycow,25.0,8.33333333333,0,0,0
levity,25.0,8.33333333333,0,0,0
shunkun,25.0,8.33333333333,0,0,0
brendanhall,25.0,8.33333333333,0,0,0
k-phat,25.0,8.33333333333,0,0,0
bulldog,25.0,8.33333333333,0,0,0
pvc,25.0,8.33333333333,0,0,0
yung,25.0,8.33333333333,0,0,0
thomas,25.0,8.33333333333,0,0,0
hypertj,25.0,8.33333333333,0,0,0
little bill,25.0,8.33333333333,0,0,0
mojn,25.0,8.33333333333,0,0,0
grunyan,25.0,8.33333333333,0,0,0
dr. light,25.0,8.33333333333,0,0,0
karl,25.0,8.33333333333,0,0,0
pastor,25.0,8.33333333333,0,0,0
wolfcry,25.0,8.33333333333,0,0,0
ldz,25.0,8.33333333333,0,0,0
afro,25.0,8.33333333333,0,0,0
bedgar,25.0,8.33333333333,0,0,0
s≈çcrates,25.0,8.33333333333,0,0,0
l0n3r,25.0,8.33333333333,0,0,0
k8,25.0,8.33333333333,0,0,0
esuma,25.0,8.33333333333,0,0,0
filet,25.0,8.33333333333,0,0,0
xbc30ep450,25.0,8.33333333333,0,0,0
refriedjeans,25.0,8.33333333333,0,0,0
core,25.0,8.33333333333,0,0,0
lunchy,25.0,8.33333333333,0,0,0
baedough07,25.0,8.33333333333,0,0,0
travkid,25.0,8.33333333333,0,0,0
scuttlebug jamboree,25.0,8.33333333333,0,0,0
nikku,25.0,8.33333333333,0,0,0
da bear,25.0,8.33333333333,0,0,0
tootmoses,24.9951569578,4.06903205675,3,4,7
sandman,24.9887255082,4.55877458215,3,2,5
village mascot,24.9720194108,2.21785316964,11,14,25
imdabes,24.9544618082,4.9329171002,2,2,4
yass2queen,24.9521629583,5.55029356187,1,2,3
lou_sanus,24.9405107221,1.45632123457,21,24,45
biz,24.9105463818,3.4963257031,3,4,7
dr.yonz,24.9075704745,3.02117600643,4,4,8
jc_chill,24.8816904935,4.66007647926,2,2,4
hayrow,24.8760716524,5.60963176016,1,2,3
pintoa,24.848069,2.52191488918,8,9,17
alex,24.8314472944,3.94117351972,3,5,8
olikus,24.8187241546,4.48857280721,2,3,5
shaddi,24.8083318612,2.77577483584,6,6,12
dasit mane,24.8054783952,5.29757846679,1,2,3
pidgezero_one,24.8030371179,4.92260328023,2,2,4
7blanks,24.7857655914,4.03426846924,3,3,6
vanillarin,24.7809754632,3.89355343093,3,4,7
yeye,24.7731471757,4.27184364627,2,4,6
tafokints,24.7481474278,5.98106833786,1,1,2
schmerka berl,24.6962177936,2.51959346946,7,11,18
daddy's milk,24.6676852937,4.12856222723,3,4,7
blueman,24.6570866237,4.14648034662,3,4,7
soulbroker,24.6490965711,4.77612071047,1,2,3
dankestdad,24.6437415848,3.67614204639,4,4,8
barron,24.6388741113,5.14153367566,2,2,4
tetsu0,24.6262993259,5.03796166079,2,2,4
handles,24.6126461664,2.10961692965,10,11,21
dount,24.6060569127,4.09402006283,3,3,6
mmneggs,24.5976557766,3.37718265595,2,6,8
whuck,24.5828430357,4.01651529369,2,3,5
drinkwildturkey,24.5610439659,3.38047282962,4,4,8
et,24.5546784037,1.87064429278,10,18,28
thissidedown,24.5513665815,5.43925573599,1,2,3
tmakk,24.5249790204,3.24617068526,5,6,11
aces,24.5073475022,2.62233184478,6,11,17
fanboy,24.4889711,5.72519963919,1,2,3
cashhole,24.4830276458,5.40967314731,1,2,3
collin the conqueror,24.4582480014,5.06356359914,2,2,4
satch,24.4484190474,5.04404046701,2,2,4
dusttin,24.4403843695,2.20696366234,10,13,23
luigikid,24.3970096336,5.00145699011,2,2,4
pettanko-senpai,24.3925171387,2.66184140821,7,6,13
jazzy jinx,24.3888989225,4.61063078292,2,2,4
hotpocket,24.3772956201,2.48592955948,8,10,18
chicken,24.3302488377,2.98041735151,5,7,12
tauvalian,24.3283622006,5.04985079081,2,2,4
reese,24.3021092979,4.43609296046,2,2,4
sombrero,24.2179958312,5.24435673891,1,2,3
esid,24.2104572144,2.14184459027,10,9,19
monkey,24.2022089497,2.0390127686,10,13,23
gamer4life,24.1936988112,4.62671965627,2,2,4
chevrium,24.1837744299,3.68885352698,3,4,7
moist,24.1742036403,4.99802031958,2,2,4
enemajoe,24.1684995449,3.24262231,4,4,8
smashg0d,24.1473408161,5.37571815839,1,2,3
k-nut,24.1365368992,4.29427694186,2,3,5
david barker,24.1289778633,5.6028320226,1,2,3
skrull,24.0382413029,4.94514045373,2,3,5
drewgong,24.0332074786,1.78465402833,13,16,29
gaggleforce,24.0169079376,5.21324147886,1,2,3
dsj,24.0075365443,2.6695490569,6,6,12
sunshinetk,23.9911996257,4.72938122836,2,3,5
pzero39,23.9791133007,2.11699041716,10,15,25
natural brother,23.9755863226,2.90074738433,5,8,13
jinjo,23.9700897429,5.5704973186,1,2,3
kevine,23.9477325873,5.60074788092,1,2,3
slippypickle,23.9432694135,4.27948847285,2,4,6
costaricancool,23.9301440452,4.56037777054,2,3,5
nuggzy,23.9133660777,4.78267472168,2,2,4
savior,23.903488871,4.95466006915,2,2,4
byff,23.9022005075,4.43974237503,2,2,4
wubbs,23.8760623824,4.93138500452,2,4,6
ders,23.8689194248,3.70579700213,5,4,9
icho,23.8487082433,4.92853575691,2,2,4
jaquarium,23.8404794066,5.04087719999,2,2,4
camerino,23.8388918412,4.1774175852,2,4,6
khakis,23.8195168002,4.66275126303,2,3,5
dirtcruncher,23.8081199349,3.34521926927,4,6,10
waldo,23.7825553119,4.19578685754,2,3,5
cmac,23.7486463017,3.29630842178,4,6,10
gaijilla,23.7335000994,5.89458141807,1,2,3
mr. biz,23.7210641953,5.05089869586,2,2,4
monad,23.7123955241,1.5054401631,17,31,48
probers,23.6839741158,4.62700656,2,2,4
truffleshuffle,23.6788769285,4.52693030002,2,3,5
zenaga,23.6761009151,5.50042648943,1,2,3
cane ut,23.6549204142,5.43120541704,1,2,3
majin_bukkake,23.6103316459,1.94816492475,11,16,27
puncayshun,23.5991567939,3.56136512109,4,3,7
papaghanoush,23.5974978657,3.54321898966,3,4,7
wheels,23.5690926248,2.18399645034,8,7,15
searing scar,23.5669105082,4.41053698052,2,4,6
izoo,23.5371695413,5.42181231484,1,2,3
wal,23.5336824981,5.76636514869,1,2,3
capos,23.5311167364,1.11908355887,43,54,97
b.i.,23.5205340351,1.95762006742,9,13,22
file,23.4901943144,2.60292930156,8,5,13
kingkool,23.4843114457,2.48826591774,8,10,18
arctic,23.4684294881,5.40148296815,1,2,3
chronicmexican,23.4450561006,2.45047008935,6,12,18
bre,23.4327509431,2.34334198764,7,9,16
staysleepin,23.4203701157,2.91994726541,4,8,12
sonicfuzz,23.4128777498,2.02928646721,12,15,27
moze,23.381054954,4.99312119924,1,2,3
pochilin,23.3686415636,3.89578154083,3,5,8
rawdog,23.363334365,5.06369679768,2,2,4
steamfriedasian,23.3621246951,5.73391255533,1,2,3
-philip coast philip-,23.3460507534,5.25167639573,1,2,3
derstuk,23.3376475442,2.16687235413,10,12,22
thrillhouse,23.3013154078,1.83299464752,11,17,28
gera,23.2851911871,5.48739664317,1,2,3
sph,23.27614359,4.5186933381,2,3,5
neth,23.1861020266,5.49320539377,1,2,3
bhol,23.1721486726,2.25652079555,8,11,19
qtip,23.1471201424,5.96320374501,1,1,2
dwreck,23.1427050378,5.50870913819,1,2,3
grahamaglam,23.1300493339,1.93470082481,8,16,24
chino san,23.1289345722,5.4208122537,1,3,4
clefairy as mew,23.0927379524,4.95371121424,2,2,4
bottle opener guy,23.0623334097,3.3632243122,4,4,8
weedlypuff,23.0569645152,3.21367206359,4,5,9
andy,23.049496984,3.15743124847,3,6,9
masquerade,23.0480593414,5.50126583567,1,2,3
matt,23.0410369134,3.23662361889,3,5,8
ardent rage,23.0390518825,5.33053236201,1,2,3
bimbo,23.0283462736,2.95028467513,4,5,9
dex,23.011135291,7.26144247377,0,1,1
garv,23.0093845888,3.94328771045,2,2,4
gibbles,23.001146689,4.98576195411,1,2,3
jaapoh,22.9967396955,3.613619952,3,4,7
kman,22.9932321123,5.67901093998,1,2,3
minymidge,22.9801453123,2.16274056567,7,16,23
stylisland,22.9548393931,4.87468128019,1,2,3
billbacon420,22.9509202495,1.42840218571,20,31,51
ditto,22.9314095472,2.34315247449,7,11,18
ajbcdefg,22.9268427754,1.44048574044,22,29,51
pluto,22.9092643073,5.56218526537,1,2,3
asaaj,22.8752423692,3.29581911621,4,4,8
nigel_thornberry,22.8525552656,5.24517339621,1,2,3
bean,22.8483371217,1.75215488107,12,25,37
brny,22.835010313,5.26675091251,1,2,3
sinbad,22.8304218592,5.42109445474,1,2,3
zibba,22.8170969194,7.24300767435,0,1,1
leaf fc,22.8068926824,3.23726384012,4,6,10
lordtoko,22.7731523514,2.74683522692,5,7,12
dankpank,22.7542174919,1.36453206051,23,33,56
bflakes,22.7529400049,1.9229208536,11,16,27
duncs,22.7499962276,1.56837002746,20,24,44
greenblob,22.7492272092,2.9286746189,4,7,11
bodacious,22.7456335897,4.10770698892,3,4,7
dsyr,22.743934739,4.00204940635,2,2,4
xanz,22.7216903438,5.09008313622,1,2,3
bonerstorm,22.7131543348,5.03759629022,1,2,3
goosewithsocks,22.7017899135,1.56388985274,18,23,41
silver,22.7014313113,3.1494236218,4,6,10
verwaltung,22.6867102224,5.67101579923,1,2,3
egg,22.6848235263,7.13555646269,0,1,1
drewskii55,22.6773296708,7.1998936357,0,1,1
crazyk115,22.675195546,5.13123091144,1,3,4
rgood,22.6568814078,5.22740397957,1,2,3
xif,22.6514029781,7.12491104683,0,1,1
aisengobay,22.6281627487,5.02165362371,1,2,3
boh,22.6263883891,5.22409885802,1,2,3
nanagens,22.6222223669,2.84222372185,7,5,12
cooljoe,22.6161343304,5.22917378086,1,2,3
foda,22.6031079767,1.94817976139,11,14,25
cyan can,22.5948869503,3.56966456156,3,6,9
hotahota,22.5770554857,2.74052370745,7,7,14
cuppajoe,22.5614711416,3.98912966001,3,4,7
evals,22.5497261156,5.26109394584,1,2,3
zhao_guang,22.5423938971,5.28363332444,1,2,3
robnu,22.5361970475,5.27291984814,1,3,4
schlag,22.5295736344,5.64093463869,1,2,3
keagsbsmashin,22.505682607,4.93161471885,2,2,4
lldl,22.4754387364,5.54602983821,1,2,3
momdameatloaf,22.469612028,2.75417370771,5,6,11
bohemian milk,22.4410234019,5.64191828862,1,2,3
mourin,22.436189438,5.53322447519,1,2,3
rythemretrn,22.4257927027,5.54390698698,1,2,3
okay,22.4199546536,5.79941742904,1,3,4
hsf,22.3577182729,5.21749074515,1,2,3
bombproof,22.342559498,3.12357030836,4,7,11
tokaji,22.3418384892,5.72549549374,1,2,3
the professor,22.3357851457,3.93517245049,3,5,8
zergos,22.3315068932,3.28090201066,4,6,10
panda,22.3237623735,2.87046791405,5,9,14
maaron,22.3235126558,5.2279102694,1,2,3
rebel scum,22.3120968499,3.35281578104,3,5,8
milleneum,22.3048042501,2.66519851035,5,10,15
yakal,22.2950630033,5.45881954507,1,2,3
green eggs and spam,22.2875577924,3.98001502313,2,4,6
widdy,22.2800191475,1.77297259024,14,27,41
sun vulcan,22.2630109463,3.9758599453,2,4,6
happens,22.25165231,3.37906272484,3,5,8
adrian,22.2449221962,5.4939042246,1,2,3
geekliftus,22.2334848055,5.51993490319,1,2,3
train_town,22.2182491195,5.25970810876,1,2,3
squible,22.2033767014,2.73894108261,6,7,13
moonshoe,22.1954440237,1.22655710738,30,49,79
hunter,22.1937110818,2.20628428884,7,11,18
prism,22.1846826736,5.77103200607,1,2,3
grrg,22.1701698268,2.5691539874,6,11,17
toez,22.1554000087,5.17921738618,1,2,3
mickeyo64,22.1535369022,5.04651356865,1,3,4
cbones,22.1425979996,5.17784168517,1,2,3
chiefreaper,22.1151859141,5.33476205532,1,2,3
omar,22.0870798817,4.53195552111,2,4,6
giraffe,22.0832446758,5.52720444839,1,2,3
mrryanness,22.0367418756,3.72802524563,3,7,10
hotspank,22.0340178894,2.53676503282,6,12,18
hamburglar,22.0313772247,5.47262274073,1,2,3
hbrw-hammer,21.989450955,5.19683618143,1,2,3
mrpoo,21.9694395301,5.5090539933,1,2,3
banana fiend,21.9571408911,5.00477127102,1,2,3
mr. tit,21.9538158227,2.54194345469,5,7,12
zarc,21.9523180178,5.3661603852,1,2,3
han,21.8966597569,5.31977588561,1,2,3
kzidek,21.8867795024,5.53430238446,1,2,3
papasquat,21.8723535112,1.62519960798,12,27,39
sebson,21.7709279685,4.86920358734,1,3,4
kristoff,21.745955427,1.91123876456,12,19,31
kaddy,21.7448383797,6.97871477739,0,1,1
ocelot,21.7333192827,2.09380750445,6,19,25
pizzajokes,21.7162054905,5.50815225737,1,2,3
paco [larkin],21.7159475813,5.45508770932,1,2,3
fawnco,21.6867950646,5.49425252058,1,2,3
burnt out ninja,21.6867950646,5.49425252058,1,2,3
keatsta,21.6863624733,5.27399647901,1,2,3
cardoso,21.6780577038,5.47180539926,1,2,3
eggmcmuffin888,21.6438948514,2.48388982716,5,9,14
gumbolaya!,21.6434793433,5.28700972786,1,2,3
iceking,21.6323098565,2.74853602902,5,12,17
elated,21.6254384535,2.05948213889,9,16,25
dax$,21.6047999737,2.65648839023,6,6,12
halffulla,21.5892763706,3.47907314315,3,5,8
moonlight,21.5742555115,2.70219717471,4,9,13
calzum,21.5714486672,5.33704979156,1,3,4
yolochi,21.5690938026,2.39029559624,7,13,20
slartibartfast42,21.5328392932,4.28071789839,2,4,6
evab,21.5281310611,5.45654170068,1,2,3
macintosh,21.5279879885,3.43709481242,3,6,9
ondas,21.5111827075,3.48818106101,3,5,8
anathema,21.5047657545,5.52858492613,1,2,3
zwephy,21.5047657545,5.52858492613,1,2,3
zombie!,21.5047657545,5.52858492613,1,2,3
jirachinick,21.5047657545,5.52858492613,1,2,3
kossismoss,21.5047657545,5.52858492613,1,2,3
trevman,21.5027061159,5.10402665286,1,2,3
weirdy man,21.4938394777,5.32664823819,1,2,3
sadu,21.4831253742,5.56869670732,1,2,3
fearlesscaboos,21.4723749368,5.35045878471,1,2,3
tipc,21.4581093639,2.91006777828,4,8,12
xiivi,21.4561162751,2.83529261908,5,9,14
jmabate,21.4375021927,5.28753891929,1,2,3
gray,21.4033586419,2.66149877143,5,8,13
v-bomber,21.4000216092,4.19284654502,2,4,6
whoopiecow,21.3422581477,5.51129103904,1,2,3
napkins,21.3422581477,5.51129103904,1,2,3
bubby,21.3396390978,5.35310713357,1,2,3
moustasher,21.323415474,2.42936042601,7,12,19
elrond,21.3222891132,2.44550758144,6,13,19
boink,21.3222781517,3.33603318091,4,5,9
fish,21.3010217384,7.11897881854,0,1,1
pikasneeze,21.254214016,2.75211738358,5,6,11
frostbyte,21.23597706,3.47845842726,3,7,10
minusev,21.228864937,7.0978953209,0,1,1
peaceful soujourner,21.1912099971,5.11435591928,1,2,3
blue bear,21.1002964099,5.55587524657,1,2,3
shasta,21.070209472,5.51002169606,1,2,3
kavon,21.070209472,5.51002169606,1,2,3
hungrybox,21.0458327936,4.48872068442,2,4,6
fingerblast,21.0282940861,4.56717238675,2,2,4
mizbiz,21.0224265044,3.26856727371,4,4,8
static,21.0214504808,3.56483542782,3,5,8
kosher,20.9781522634,3.11600516878,3,6,9
catastrophe,20.953327352,3.69889886241,3,4,7
doby,20.9424110004,4.83842669501,1,2,3
h00n,20.9362880875,3.73979440267,2,4,6
dair,20.9280381761,3.28104673323,4,4,8
zerobombjake,20.8991658236,3.22918346569,4,6,10
dr combos,20.870411986,3.28209527967,2,8,10
tallboi,20.86947576,6.62142781645,0,1,1
java boy,20.8573962319,5.51420898734,1,2,3
fuzzyness,20.8572582521,5.23816133135,1,3,4
yungpurp,20.8494147883,6.68210388938,0,1,1
apparition the ambassador,20.8457903597,1.20483267757,25,55,80
seantos,20.8445035663,1.94284359092,11,23,34
big tone,20.8406120534,7.05844745916,0,1,1
lucky_hamburger,20.8258022231,2.95226206707,4,7,11
ttp,20.8074037957,3.45116783869,3,6,9
zad,20.8037023428,3.38007051069,3,7,10
eliot,20.800150921,4.9216372622,1,5,6
fork?,20.7893836945,4.94807071575,1,3,4
dankey kang,20.7782747564,2.1522316925,7,17,24
buttery adachi,20.765461507,4.64293460531,1,3,4
mojo,20.7589379883,5.1984974191,1,2,3
lalo,20.7423750734,4.13893185685,2,4,6
jdp,20.7309203938,4.97063078468,1,2,3
joel,20.6924795156,2.78112181001,5,8,13
zouzy,20.6755344261,5.54532760265,1,2,3
hipo,20.6704005576,5.21848248582,1,2,3
brotherly,20.634392785,2.75334039188,4,7,11
nfreak,20.60416798,7.17147558733,0,1,1
uprowr,20.60416798,7.17147558733,0,1,1
akito555,20.60416798,7.17147558733,0,1,1
sfat,20.60416798,7.17147558733,0,1,1
jad,20.60416798,7.17147558733,0,1,1
kayo,20.60416798,7.17147558733,0,1,1
benbook,20.60416798,7.17147558733,0,1,1
k-man,20.60416798,7.17147558733,0,1,1
lonk,20.60416798,7.17147558733,0,1,1
ragingcherry,20.60416798,7.17147558733,0,1,1
bunmira,20.60416798,7.17147558733,0,1,1
josiab,20.60416798,7.17147558733,0,1,1
captain murphy,20.60416798,7.17147558733,0,1,1
4 phri,20.60416798,7.17147558733,0,1,1
drewjames,20.60416798,7.17147558733,0,1,1
fs shampoomaster,20.60416798,7.17147558733,0,1,1
thissideup,20.60416798,7.17147558733,0,1,1
mystery,20.60416798,7.17147558733,0,1,1
changed man,20.60416798,7.17147558733,0,1,1
5000candlesinthewind,20.60416798,7.17147558733,0,1,1
phalanx,20.60416798,7.17147558733,0,1,1
nannose,20.60416798,7.17147558733,0,1,1
sherb,20.60416798,7.17147558733,0,1,1
akajumo,20.60416798,7.17147558733,0,1,1
silent skyler,20.60416798,7.17147558733,0,1,1
penance,20.60416798,7.17147558733,0,1,1
nyani,20.60416798,7.17147558733,0,1,1
yung god,20.60416798,7.17147558733,0,1,1
queso,20.5879348179,2.8236152175,3,8,11
jaws,20.5676658066,5.35482917924,1,2,3
goose,20.5400052343,3.84714282997,2,4,6
nuro,20.5389518189,5.43185785249,1,2,3
flatline,20.5164882806,5.24452888369,1,2,3
thenuge,20.5013392426,5.04003806029,1,3,4
icactusdog,20.4967120846,1.16540088287,31,76,107
tubby!,20.4468181592,3.87920233121,2,6,8
heartsdealer,20.4405992168,4.22373191901,2,4,6
three beers,20.4172944429,2.69214698309,4,8,12
voff3,20.3954522573,6.99340631441,0,2,2
zach777,20.381351933,6.32614389209,0,2,2
throwz?!,20.3712942976,5.17095113297,1,2,3
barrels,20.3686059834,3.85809326249,2,6,8
homemadewaffles,20.3612733202,6.92690169084,0,1,1
mr baninawi,20.3193599258,4.50670802383,1,2,3
cormander,20.3053951558,2.70404827849,4,12,16
hero,20.3003305973,6.88831159169,0,1,1
spunker,20.2783887162,6.64193201717,0,2,2
acerunner,20.2753513992,3.82965247691,2,5,7
e-jager,20.2644522176,4.96492876065,1,3,4
sk,20.2165431096,4.94299833828,1,4,5
caelan,20.204195046,7.0610632401,0,1,1
mighty afro dighty,20.1752464271,3.7255676448,2,4,6
butcher of bakersfield,20.1709924669,3.98886789201,2,5,7
jag,20.1688347611,3.02977457855,4,8,12
mikeyp,20.1580219349,2.64395169378,5,10,15
mjim,20.1296572253,2.69920990654,4,12,16
fritz wethermyb,20.1291454112,6.19810616093,0,2,2
teflon ron,20.1029714428,3.33052145149,2,6,8
izze,20.0991619284,4.69344535825,1,4,5
papa,20.0951075546,3.04550377338,4,8,12
bawdbabe87,20.0542548363,2.97381713306,5,8,13
aegeze,20.050287927,3.37836477677,3,5,8
nich,20.035230388,3.24884721057,3,10,13
shug,20.0173387223,3.293411964,3,8,11
accru fenix,20.0014956645,2.89598502638,3,10,13
b vu,19.9779918419,6.56462785713,0,1,1
depressed eagle,19.9668557046,4.71517261952,1,3,4
king robin,19.9444670407,5.22563126762,1,3,4
weatherman,19.9361842857,6.05438025427,0,3,3
tallyshell,19.9342139881,5.03744670312,1,2,3
takuto,19.9189135899,3.46585203517,3,4,7
kiwi,19.9122878897,3.21173212168,2,7,9
stark,19.9097779057,2.12679946266,7,15,22
maximum can,19.8807968822,6.1968182466,0,2,2
pokmo,19.8750199079,2.97730772597,3,8,11
howdy,19.8670451921,2.05843393194,11,16,27
pika,19.8665160974,4.50476058035,1,4,5
frogman [charette],19.8470685379,6.53515646093,0,2,2
nineball,19.8370536835,3.00608324151,3,7,10
danny,19.8132004678,6.8317061207,0,1,1
spt,19.8025232552,6.38548140082,0,2,2
dad's musical erasers,19.7703658544,6.34330364497,0,2,2
mikelangelo,19.7461948385,6.43727618769,0,2,2
cagt,19.7458994826,1.6248382332,16,27,43
multiball,19.741631196,2.1850813327,8,16,24
sebastian,19.620743255,2.92073989796,4,8,12
muse,19.5641431633,2.17144776435,8,14,22
rogue1wasjustok,19.5162381504,2.88055587875,3,8,11
fiasko,19.4961816781,4.80651133839,1,3,4
yaron,19.457187768,3.69052851875,1,6,7
danno,19.4480883685,5.26348120732,1,2,3
dimension,19.4061385287,6.20651346822,0,2,2
qerbstomp,19.3827577966,3.21005483456,3,10,13
diveo,19.3710398223,2.23070398402,6,18,24
tangerine,19.3597104019,2.75958559276,5,10,15
fred,19.3512733707,4.82054371145,1,4,5
fumofuu,19.3003820949,6.70094005858,0,1,1
veen,19.2649590252,6.50769593739,0,1,1
houndour,19.2327178645,4.7313095735,1,5,6
magic,19.2318449454,3.11875945263,3,5,8
missingn0,19.1950717181,6.10648839204,0,2,2
russellsprouts,19.1769716591,1.27318777487,24,69,93
rush,19.173098294,2.88082346805,3,9,12
jive turkey,19.1618763538,4.30369619918,1,4,5
krypto,19.1590647171,4.80958059903,1,4,5
husker,19.1404494768,4.23587159018,1,5,6
bluebear,19.1396939127,2.68059200083,5,10,15
laugh,19.1118702629,2.80647941252,4,10,14
bleachfanboy4life,19.0772007689,5.04730570509,1,3,4
brown_omega253,19.0495734057,6.32975483504,0,2,2
k,19.0428343177,5.95249011755,0,2,2
slatts,19.0142233499,1.76469594041,10,27,37
supernuggit,19.0075666035,2.4747020716,5,12,17
esmod,19.004211349,6.50799591405,0,2,2
skubtard,19.0028728103,6.87267909617,0,1,1
fs mook,19.0028728103,6.87267909617,0,1,1
tarn,19.0028728103,6.87267909617,0,1,1
jiffypop23,18.9782720931,3.36041385028,3,6,9
rabizkoshik,18.9387563269,4.96521521123,1,4,5
kingcool,18.9351088349,3.64474619053,2,6,8
guccipivotmaster4000,18.9347382351,6.43705129894,0,2,2
dixoncider,18.922666332,2.98221368726,4,9,13
ego,18.9220364506,6.43080985891,0,2,2
precookedbread,18.9052180392,6.13144583345,0,2,2
ensindic,18.8844096996,2.8025086463,4,11,15
dcmaster,18.8764676499,3.30960840295,3,6,9
engdrew,18.8731980479,2.71426431528,3,9,12
luwolf,18.8484820941,6.29597085244,0,2,2
quentendo,18.8228132733,6.15682060212,0,3,3
muthalova7,18.8067422312,3.29748855414,4,5,9
neat,18.7965521392,2.45439033767,4,17,21
blizz,18.7928519856,6.79635578797,0,1,1
turtlpower,18.7895018776,6.35251859374,0,2,2
littlespoon,18.7797815395,6.3597378531,0,2,2
mr.e [rohr],18.7703709704,6.52341434227,0,2,2
bananabolts,18.7542892765,4.12754503445,1,5,6
flare,18.7464074989,4.81872048822,1,4,5
iacme,18.7005700184,5.87207445275,0,2,2
duck chris,18.6843486974,6.48895532793,0,2,2
fen,18.6651960945,4.60992013254,1,4,5
wilbur,18.663023376,6.48087992329,0,2,2
jgin,18.6321608332,5.92034936976,0,2,2
kieuarty,18.611156125,6.46321841715,0,2,2
youtwo,18.6056078068,6.49184921396,0,2,2
r.o.m.,18.5588529466,6.38820575423,0,2,2
kl3an,18.5588529466,6.38820575423,0,2,2
pokeiman_master,18.5516219727,6.44406310517,0,2,2
crazy_cubano,18.5382455116,3.26138162636,3,6,9
tdp,18.5322048421,6.27670782881,0,2,2
nathansandwich,18.5270051775,3.36724833234,3,7,10
lecceo,18.5224563478,6.04122538682,0,2,2
failcant,18.5036619979,6.53954925511,0,1,1
ltdan,18.4788430109,4.30008980356,1,4,5
tbone,18.4739919389,6.26372813517,0,2,2
nagurnimaster,18.4700890997,6.22509745584,0,2,2
superkirby,18.4611593024,6.07126152759,0,2,2
ender,18.4497030966,3.08599991273,5,6,11
pugdaddyfre$hlyfeogg*flva,18.4491791431,6.2655689814,0,2,2
reno,18.4423554089,5.79143124447,0,2,2
myninja,18.4400545942,4.38110947843,1,4,5
dance!!,18.3990330348,4.26726977833,1,5,6
swerve,18.3924240113,6.39631598175,0,2,2
stdangerous,18.3869320511,6.13518467314,0,2,2
big d squirrels,18.3845697491,6.3955012082,0,2,2
master jay,18.3609401588,6.39052231831,0,2,2
cracker jones,18.3600063037,1.79350177714,9,28,37
shwang,18.3577767565,6.2521714548,0,2,2
nami,18.3449675847,6.12168390994,0,2,2
hasme,18.3361849291,5.59943655815,0,3,3
charlie harper,18.3330999134,6.38313840111,0,2,2
arcangel,18.3132158366,4.28585657655,1,5,6
mntd,18.3089968807,3.37688648383,2,7,9
oxycontin,18.3049578438,4.56472838053,1,4,5
silky johnson,18.2970933517,3.28213084333,2,8,10
blackf00t,18.2957405055,6.11791947838,0,3,3
quinceprince,18.2944270184,6.23604937648,0,2,2
vidya_james,18.2597810982,4.54149164837,1,4,5
jesusisking,18.2425746549,6.14038984196,0,2,2
tangpootie,18.2324045501,2.52637649079,5,12,17
blues,18.1874960602,4.80990360288,1,4,5
xlax,18.1874527175,4.71791538095,1,4,5
elmustachio,18.1178019254,6.11091424803,0,2,2
polarbair,18.1088484,3.42934870813,3,6,9
jdeezel,18.096134607,6.31705839702,0,2,2
shawarma habibi,18.0847842307,3.43007514233,2,6,8
tylenol jones,18.0758497583,6.32077271178,0,2,2
avian,18.0712867461,6.31842389736,0,2,2
erk,18.0475218268,6.31009962984,0,2,2
warmachine1919,18.0428187692,6.46387437135,0,2,2
sweaters,18.0428187692,6.46387437135,0,2,2
chi-fence,18.036809067,4.39262254542,1,4,5
√°1,18.0300893101,2.58432940816,2,11,13
g-rabbit,18.0254077256,2.54063691966,5,12,17
drhino,17.9980023599,6.32119878345,0,2,2
astropancakes,17.9980023599,6.32119878345,0,2,2
snack?,17.9980023599,6.32119878345,0,2,2
yam$,17.9980023599,6.32119878345,0,2,2
firefly,17.9980023599,6.32119878345,0,2,2
jpoptosis,17.9980023599,6.32119878345,0,2,2
albinosaurus,17.9829924851,6.07981880581,0,2,2
lights,17.9722012086,6.29535962389,0,2,2
beaver,17.9564848443,6.3115571796,0,2,2
elu,17.9074006064,2.86437381102,4,12,16
armagreggon,17.8975535511,3.49232440403,2,5,7
frame,17.8795899396,2.37951392868,4,19,23
ebay,17.8407852112,6.26851580688,0,2,2
bc_burns,17.8270005524,6.29388615473,0,2,2
jfm,17.8270005524,6.29388615473,0,2,2
dhir,17.8270005524,6.29388615473,0,2,2
legoman,17.8270005524,6.29388615473,0,2,2
mulkster,17.8270005524,6.29388615473,0,2,2
chaos pro,17.8270005524,6.29388615473,0,2,2
akiva,17.8270005524,6.29388615473,0,2,2
armor,17.8270005524,6.29388615473,0,2,2
espparadox,17.8154314719,1.65857145094,11,33,44
pajhomas,17.799397675,4.27782955674,1,4,5
massimo,17.7929138053,5.80630293942,0,3,3
austntatious,17.7829509186,6.06931121416,0,2,2
aerodet,17.7626693932,6.38009936753,0,2,2
jello,17.7598576448,3.26194159727,2,11,13
nadamoor,17.7571849257,6.26686880382,0,2,2
brambramjam,17.7281304498,6.03039661814,0,2,2
tehz,17.7259504036,3.38896266726,2,8,10
frogge,17.7193296658,5.91111489472,0,2,2
jackmehoff,17.7135963077,5.86190286565,0,2,2
charlie,17.7006913652,6.02158775086,0,2,2
broonz,17.6698839946,2.08474678876,7,20,27
liam_butler,17.6673384456,6.26628461383,0,2,2
matt47,17.6673384456,6.26628461383,0,2,2
colt,17.6613529856,6.33021997137,0,2,2
 ô·¥è·¥Ö·¥Ä·¥Ñ…™·¥è·¥ús,17.6441979245,3.89311799681,1,6,7
ccm,17.6385397202,4.01779425649,1,6,7
meowmix,17.6266210627,6.3460739567,0,2,2
luka,17.6239386875,3.73618149051,2,6,8
maxi,17.6227902384,6.22931743478,0,2,2
whitegrizzly,17.6211632096,6.0044317998,0,2,2
pigwick,17.6145656845,5.7986697379,0,2,2
scootieloo,17.6025155386,5.99030365635,0,2,2
general1712,17.5779881362,5.47693709977,0,4,4
coolguy76,17.5607501802,3.39884173583,2,6,8
bozz,17.559839839,6.18922189329,0,2,2
jollie,17.5463577994,1.68953022439,11,34,45
blank,17.5269841039,5.98245346039,0,2,2
the drew,17.5267640846,2.43982127081,4,16,20
rodan,17.5167074005,5.80608254359,0,2,2
leet,17.5101028793,4.19115218161,1,6,7
gambit,17.4724485757,6.03130753421,0,2,2
maestro,17.4681984749,6.2394819151,0,2,2
chinstrap,17.4649334833,4.56998857617,1,4,5
mechanicalmarine,17.4524072942,6.30688568514,0,2,2
scraggus,17.4207899857,6.18548881364,0,2,2
sugaaku,17.4088983955,2.50202039422,5,14,19
catlover321,17.4084534611,4.1468436764,1,4,5
ponkapa,17.3975387978,4.12961779106,1,8,9
spammalanche,17.3808404331,5.78956623125,0,2,2
capsui,17.3711993288,4.18493946326,1,7,8
caleb,17.3674403995,6.09652789391,0,2,2
hollow,17.3322596082,5.18714537873,0,3,3
sad,17.3097710331,6.27674314988,0,2,2
jonnjonn,17.3050028059,1.60466206574,11,37,48
harmless,17.2905728248,6.22322606387,0,2,2
mikeyg,17.2894835768,5.66175718426,0,2,2
cennis91,17.2720044365,3.59646349835,1,11,12
highlyeducational,17.2602278329,6.07035824737,0,2,2
beets,17.2574844776,5.62221721859,0,2,2
louieg,17.2302184826,5.92760188249,0,2,2
juan doe,17.2249232193,6.2595773321,0,2,2
spell,17.2151669055,3.42411362999,2,7,9
caprigon,17.1897864294,5.85995409812,0,4,4
iamlazee,17.185740056,5.94441200211,0,2,2
lv20ninja,17.1780032245,3.22953728674,3,7,10
ohhhbreezy,17.1645697169,4.37309275394,1,4,5
ppdmd,17.1573329149,6.26923433457,0,2,2
holosly,17.1573329149,6.26923433457,0,2,2
beech,17.1562143573,3.35975892206,1,12,13
kraken,17.1398541025,6.28212270869,0,1,1
sunkin,17.1391075866,6.24032360265,0,2,2
superflopp,17.1368677043,2.65170976439,3,9,12
master j.j.,17.1358355436,6.24039459921,0,2,2
jgly,17.106151725,4.23990803021,1,4,5
starcutter,17.1011463592,6.0665411989,0,2,2
driftintheabyss,17.1009098272,6.2415552758,0,2,2
amaya,17.0988004859,6.241919664,0,2,2
dinner,17.0933637711,6.08039702859,0,3,3
professortoke,17.0687245716,6.10829201917,0,2,2
sam,17.0659865662,5.90317544352,0,2,2
pale,17.0512296977,3.43089327323,2,6,8
zarfon,17.0353081779,6.09705358847,0,2,2
hotsauce,17.0321729759,2.93797588683,3,8,11
ravioli,17.0284430048,6.30597887962,0,2,2
mr_sharpie93,17.021854216,6.22090893961,0,2,2
second boss,17.0152182239,4.80073610873,1,2,3
black rob,16.9946507075,6.21682728317,0,2,2
drlight,16.9870335546,5.93536565379,0,2,2
sianvar,16.9633446681,6.49717447875,0,1,1
giggitoxin,16.9572689606,6.19807969429,0,2,2
myroknpancakes,16.9555780269,3.33309761267,2,8,10
kastakatter,16.9544687841,5.64465623214,0,4,4
15(ichigo),16.9273178368,6.23983584333,0,2,2
sambook,16.9273178368,6.23983584333,0,2,2
beekle,16.9273178368,6.23983584333,0,2,2
miles,16.9273178368,6.23983584333,0,2,2
waffles,16.9273178368,6.23983584333,0,2,2
irish,16.9273178368,6.23983584333,0,2,2
j,16.9273178368,6.23983584333,0,2,2
dd,16.9273178368,6.23983584333,0,2,2
abc,16.9273178368,6.23983584333,0,2,2
heisenberg,16.9273178368,6.23983584333,0,2,2
grraffe,16.9273178368,6.23983584333,0,2,2
muthaluva777,16.9273178368,6.23983584333,0,2,2
raxcity,16.9273178368,6.23983584333,0,2,2
gaymer,16.9273178368,6.23983584333,0,2,2
shadow light master,16.9273178368,6.23983584333,0,2,2
qk shkz,16.9273178368,6.23983584333,0,2,2
red,16.9273178368,6.23983584333,0,2,2
paper tiger,16.9273178368,6.23983584333,0,2,2
rickter_scale,16.9273178368,6.23983584333,0,2,2
uh what,16.9273178368,6.23983584333,0,2,2
draxsel,16.9273178368,6.23983584333,0,2,2
yuxminato,16.9273178368,6.23983584333,0,2,2
umi,16.9273178368,6.23983584333,0,2,2
azzy,16.9273178368,6.23983584333,0,2,2
sfgman,16.9273178368,6.23983584333,0,2,2
searcher,16.9273178368,6.23983584333,0,2,2
tuna,16.9273178368,6.23983584333,0,2,2
edwin...,16.9273178368,6.23983584333,0,2,2
deku,16.9273178368,6.23983584333,0,2,2
digital cannon,16.9273178368,6.23983584333,0,2,2
d-tek,16.9273178368,6.23983584333,0,2,2
zurdo,16.9273178368,6.23983584333,0,2,2
jazz,16.9273178368,6.23983584333,0,2,2
themickeynick,16.9273178368,6.23983584333,0,2,2
sunshine,16.9273178368,6.23983584333,0,2,2
riseup93,16.9273178368,6.23983584333,0,2,2
zombieheart84,16.9273178368,6.23983584333,0,2,2
aubfox,16.9273178368,6.23983584333,0,2,2
theycallmechris,16.9273178368,6.23983584333,0,2,2
bearrimshot,16.8930082305,5.10179797121,0,3,3
jojohnson,16.8847446083,5.91443560749,0,2,2
dexter,16.839903864,5.72358265513,0,3,3
krutchby,16.8366823264,6.18674458762,0,2,2
shyguyking,16.8278588736,5.63034924809,0,2,2
bunnyblast,16.8164815237,6.1927063121,0,2,2
kohenbro,16.8078355606,5.51238629639,0,4,4
castaway,16.8048785331,6.06752345676,0,2,2
m2cain,16.7880607121,6.19335774512,0,2,2
halqery,16.7876947692,5.27460913524,0,4,4
babycakes,16.7802622941,3.37489959916,2,6,8
trogdorbad,16.7801917306,4.70755790954,1,2,3
mookie,16.7790762933,6.17549228699,0,2,2
sabe,16.7712052572,3.20274526257,1,7,8
comb,16.7686167815,3.52308750988,2,7,9
superduperfanofboom,16.7666227916,6.17256403512,0,2,2
robslabgod,16.7628618487,5.72732565238,0,2,2
vex kasrani,16.7461775876,3.46523062907,2,9,11
keychain,16.7200670824,3.82987333613,2,4,6
saltking,16.7041564109,5.18692971223,0,4,4
jungle,16.6691833775,4.84529178943,0,7,7
jerzilla,16.6612408912,6.01798349036,0,2,2
rockmix,16.6388514883,5.94206707005,0,2,2
rollock,16.616797382,5.42615040578,0,3,3
silentknight,16.609691351,4.36384328756,1,6,7
sven stormbeard,16.6034864461,3.56579478208,2,6,8
scott,16.5972710002,6.15290821858,0,2,2
chibama,16.5746360227,4.23776089441,1,4,5
falker,16.5673739108,3.31000609897,3,7,10
jpeghero,16.5542790113,5.72001128222,0,3,3
madara,16.5422506978,5.28703986266,0,4,4
instacover,16.5173598147,6.03304199256,0,2,2
ejmp,16.4965744596,6.14530357824,0,1,1
dmolz,16.4944034609,4.97088534466,0,4,4
atari,16.4736543447,2.46546665843,5,15,20
lunarnova,16.4689013839,2.03160136915,6,32,38
curiousplaces,16.4686400239,5.98022918707,0,2,2
jedipanda,16.4647915137,4.78519132867,0,5,5
nnaughtydogg,16.3737904301,5.12906693269,0,4,4
bogmyer,16.3677235569,5.87555636419,0,3,3
magfmur,16.3354417012,5.811464978,0,2,2
nuggz,16.2888874638,3.6111937175,2,10,12
recneps,16.26011104,4.30110440634,1,6,7
mattatari,16.2268292427,4.35318512134,1,5,6
dr gibs,16.2021899007,5.23131951349,0,4,4
dinkleberg,16.1387773869,6.1112748168,0,2,2
thegoat,16.1110336081,6.0577218926,0,2,2
rocktimus crime,16.0992903732,4.77460142995,0,5,5
lord horatio,16.057460515,5.55651416398,0,4,4
i use tap jump,16.0315557336,3.71908158904,1,6,7
bill,16.0273711526,3.87098597951,1,6,7
jedisalazar,16.0199757813,5.71550570122,0,2,2
scruffy mcwonder crumpet,16.0175737446,3.29149223068,3,7,10
frog,15.9965808401,4.49530087768,1,4,5
bluey,15.9662824848,5.3649647263,0,4,4
bennypuff,15.9431417749,3.52772370148,2,7,9
elitescoringguy,15.9254168757,2.56529306155,3,14,17
duma,15.9087217116,3.61535621703,1,8,9
redwolf,15.8831330222,5.97846405882,0,2,2
noelkitten,15.8731505615,5.65452520089,0,2,2
mrkymrk,15.8710956831,4.78032213274,0,5,5
eclipse,15.869399921,5.17879421218,0,4,4
yolft,15.8318461526,2.41305856615,2,21,23
12ties,15.8310847325,3.47774204364,1,5,6
thedarkdreamer,15.802391653,6.01484204148,0,2,2
codytappen,15.7853216507,5.6088576584,0,2,2
lampyshade,15.7844659241,5.40867968261,0,4,4
jackkenney,15.7585225492,5.64899828726,0,2,2
blahguy,15.7454563257,5.81008494948,0,2,2
lloyd-black,15.7316993222,3.58247607771,1,8,9
turquoise,15.7280380596,3.26425063634,2,7,9
vondo,15.7240700032,4.72021122034,0,5,5
2%gay,15.7132141923,4.07071667017,1,8,9
spaz,15.7082057723,4.19170770288,1,4,5
don,15.7073341492,3.55900760284,2,5,7
twunt,15.702085813,2.91263246159,2,13,15
norwayray,15.6835431236,5.25368994556,0,2,2
dk dredd,15.6475640437,5.91830761396,0,2,2
mm720,15.6466638313,5.58367614202,0,4,4
kobra,15.5968343475,3.16495075379,2,11,13
uncle onion,15.5522960143,5.93876560258,0,2,2
katiebug (sfk),15.5257668944,5.60340187496,0,2,2
tydye,15.4962095478,5.71435404844,0,2,2
bennyboy98,15.4862446417,5.96174045904,0,2,2
swankeaboo,15.4672023153,4.83931128458,0,6,6
shimshamlando,15.4369995966,2.30795924738,4,28,32
lou sanus,15.3809767544,4.5666113781,0,6,6
fmaj7,15.3793071381,3.88108056486,1,6,7
t-bone,15.3742337921,3.41401078122,2,6,8
mzadeh,15.3367085939,5.22447467963,0,4,4
peacemaker,15.2674983855,4.37762292747,0,6,6
tanuki,15.2414745664,5.77050178339,0,2,2
lvl99wizard,15.2301734611,4.90263121072,0,4,4
tron,15.2082890811,5.60704939094,0,4,4
mariokartmoney,15.2023991933,5.46979181665,0,4,4
vnko,15.1940074153,4.14610870276,1,4,5
ir,15.1925746877,3.9018658966,1,6,7
godspeed,15.1675586068,4.06536906148,1,7,8
kezzup,15.1390907743,3.62834703633,1,8,9
bagel,15.1356957542,5.1963265951,0,4,4
dude wut,15.1247812655,4.50987850688,1,4,5
thisisgettingold,15.115537955,5.93072884891,0,2,2
wiseacre,15.1081384418,3.57139739676,1,11,12
bung0o,15.0861921012,5.20344175089,0,4,4
zbomber,15.0451664486,4.94094957592,0,4,4
warhorse,15.0451430566,3.76764605288,1,6,7
rumi1819,15.032520988,5.2518568278,0,4,4
fry,15.002176525,2.92542400536,2,13,15
dyo,14.9962823249,3.54210382331,2,6,8
dr-wumbo,14.9839655426,5.50492602216,0,2,2
ceephax,14.8595237801,5.78946898394,0,2,2
captainpugh,14.8463641402,5.5289679154,0,4,4
hufff,14.8461070227,3.63029316025,1,6,7
fig,14.8379883515,5.44294090835,0,4,4
adulix,14.7935449934,4.99541774313,0,5,5
meccs,14.6959721634,5.01921432148,0,5,5
bchill,14.6683971832,3.20818046751,2,7,9
snoosnoo,14.6669504422,4.23920453613,1,4,5
feartheday,14.6093609234,2.8822301596,1,18,19
cnasty613,14.6054060097,3.46157290119,2,6,8
kevorkian,14.5897236372,2.82559100835,3,13,16
showtime,14.5887361904,5.82355811529,0,2,2
bear,14.5885031086,5.31724245585,0,4,4
drunkn smash,14.5534941834,4.50693640475,0,5,5
goofinhiemer,14.5138568615,4.98917492594,0,4,4
midgetto,14.5060420245,2.31117671018,4,18,22
fmax,14.4895155373,5.50407742618,0,4,4
dennysgrandslambreakfast,14.4881067121,5.16725848198,0,4,4
marfthekid,14.475981024,5.52612044732,0,4,4
yaks,14.4266473094,3.69175440413,1,8,9
hiddenmi$t,14.3565516921,4.93835050604,0,4,4
ngwn,14.3404746879,3.40091379906,1,9,10
cag,14.3368913197,5.13462413617,0,4,4
armadillo,14.3347622673,4.55669581071,0,6,6
ryden hope,14.2910190469,5.6998136168,0,2,2
auggie,14.2389363489,4.08007823156,0,9,9
sevshun,14.2367949633,3.41253143494,1,9,10
rhubarb,14.2328761917,2.40278897499,3,18,21
usvn,14.2264165195,3.37315367248,1,11,12
spaghetti,14.2181527533,3.01952759252,1,11,12
cgmontage,14.1785356296,4.15735379647,0,7,7
fj20,14.1136191561,3.17555759344,2,7,9
primefry,14.0887548349,3.06664447785,1,11,12
chacalaca88,14.0618361298,4.51745322906,0,6,6
hiv+,13.8937762603,3.40145373315,1,8,9
myk,13.8626267077,5.36647171848,0,4,4
edgar allen pwn,13.8505261073,3.61735402696,1,10,11
oquinn,13.8470837684,4.40153378229,1,4,5
chibaco,13.8469276725,4.24057856111,0,8,8
telemonic,13.8421390478,5.11102939293,0,4,4
road-rage 64,13.7973496136,4.50238582267,0,6,6
turtle,13.7797127898,4.4008125827,0,8,8
bort,13.7157881423,4.06114831604,0,6,6
rich,13.7007160926,4.94211244526,0,5,5
mf space,13.6950908639,4.7319683007,0,5,5
kronk!,13.6708895252,2.63612715694,2,18,20
frapple_apple,13.6654282722,3.50493192227,1,7,8
scruff,13.6055911649,4.97176045869,0,6,6
mattc,13.5958064028,4.33179617236,0,5,5
lotionhole,13.5877893449,4.41863786612,0,6,6
mike4real,13.5864551055,3.33642494603,2,10,12
bluntsmokinganusdestroyer,13.5614865784,5.34982498022,0,4,4
cat,13.5100554597,4.71980783012,0,5,5
hashi,13.4997171052,2.43764528938,3,22,25
whiz kid,13.4212074591,5.16852123362,0,4,4
blanco mano,13.4015177081,4.59893174621,0,5,5
scaryman,13.3668329574,4.32703399476,0,6,6
heavy,13.3666787603,4.15893933057,0,5,5
ben,13.3632972971,2.54992200013,2,16,18
woof,13.2208606529,5.01298816141,0,5,5
gato,13.1992338743,4.418841289,0,5,5
hwatts,13.1778363574,3.67364436067,0,13,13
dabs?,13.1778232567,4.09533295753,0,9,9
mop,13.166837525,3.27951038642,1,8,9
neff,13.0963279162,5.55821322955,0,3,3
sour,13.0128843908,3.75374918999,0,10,10
oldiz,13.0109966275,5.11792024559,0,4,4
greatwhitebuffalo,13.0058296911,4.66084691881,0,3,3
godofgrunts,12.9891988686,4.75846896551,0,7,7
brother quang,12.9025426825,3.33492689741,2,8,10
lotus,12.8993038343,5.4772260238,0,2,2
weslec,12.8971991285,3.74884546984,0,8,8
zorro253,12.8830677072,3.25210131447,1,10,11
monica,12.8133167623,4.5803659133,0,5,5
boogie!,12.7715394391,3.01436416914,1,14,15
nardwell,12.7024403405,1.87898738218,6,45,51
twisty,12.67877563,2.58130818246,2,27,29
rokd,12.5686934827,4.60696435048,0,4,4
jimbot,12.5261010076,4.50079562529,0,7,7
phynque,12.4633140889,3.45410317566,0,12,12
atlas,12.4377098182,2.96880655089,1,13,14
gasmask,12.4337537853,3.91517746881,0,8,8
tyler_stewart8,12.315264538,3.60317440904,1,6,7
fabulousboy,12.3098085824,3.83477484469,0,9,9
terrible fate,12.2806335698,3.52122425275,1,12,13
putpasswordhere,12.2526491771,4.50520273441,0,8,8
ohb-noa,12.0949622758,4.13515953987,0,8,8
neph_girl,12.0914061653,2.9503011347,1,14,15
lolitaz667,12.0471665372,3.33051881552,1,8,9
doublej,12.0446017086,3.55594718657,0,13,13
b rod,11.7960972506,5.01545162823,0,5,5
jame,11.7085715731,3.36639786253,1,10,11
syph,11.6957705692,3.6283111535,0,9,9
little things,11.6541874576,4.01007411226,0,7,7
nicklebackair,11.6199720233,3.50528139374,0,9,9
whitezebra,11.5326866456,3.57941069248,0,10,10
mambo,11.4461689339,4.89573239612,0,4,4
half man,11.4022044164,3.67156604612,0,8,8
microwaved hotdogs,11.3755618066,4.09959040875,0,10,10
baloo,11.3372645076,4.4882581202,0,5,5
t3rquoise,11.3114200218,3.83471555955,0,10,10
stormcrow2,11.2875346102,3.47025352882,0,9,9
ranger,11.2359287385,4.06892267302,0,10,10
reject,11.0811949712,2.51298680155,1,27,28
mello,11.0141704976,3.16548533231,1,16,17
qwesseccssffdy,10.9105207928,4.93788158282,0,4,4
stevenballoons,10.8836784392,3.14305496382,1,9,10
jerry bean,10.7557394216,5.18052624163,0,2,2
2p,10.5300584678,3.31686574744,0,16,16
knothy,10.5213111933,3.6261892397,0,12,12
ceec,10.4817963984,3.43608175633,1,10,11
brizzles,10.3913486365,4.01689115232,0,8,8
lloyd.,10.1723066681,3.64489588858,0,9,9
