player,mu,sigma,wins,losses,sets
hwats,9.89576290834,3.56155808612,0,12,12
yung duccboii,9.84795097794,3.96280051969,0,7,7
seaniemaster,9.64619327066,3.79730567467,0,8,8
macrado,9.53042669409,3.41244861722,0,13,13
gluu,9.48568932672,3.89019579462,0,6,6
jet fuel,9.32862962398,2.9015103018,1,16,17
soggy biscuit,9.13837238341,3.39809398905,0,9,9
seaweed dragon,8.98801408099,3.70441935455,0,8,8
golfclubninja,8.64994687135,2.811811369,1,28,29
archduke,7.49722904733,3.60790440722,0,9,9
superboomfan,51.1108369093,1.18754821597,192,11,203
alvin,49.0742978728,1.20473181085,87,11,98
fukurou,48.7659429303,1.57780354207,42,4,46
wizzrobe,46.3070193393,1.07566294303,109,23,132
kysk,46.279424961,2.03396894046,18,4,22
kurabba,46.0583952843,1.93208673816,20,4,24
wario,46.0361220684,2.28887220021,18,3,21
mariguas,45.8698883278,1.0898541741,112,24,136
wangera,45.3469383675,1.69756172354,29,7,36
dext3r,45.0375102279,1.15389264007,77,20,97
gerson,45.0368458792,3.0640049891,10,0,10
kerokeroppi,44.9664988758,1.07584845323,88,25,113
isai,44.6950441362,1.25989205768,68,15,83
tacos,44.2018511045,1.19959955883,80,21,101
zero,44.084502492,1.1098731097,92,22,114
fox,43.4731327988,1.2969774094,56,12,68
prince,43.466012524,2.15614608641,17,4,21
joshi,42.6813332942,1.84845329903,21,5,26
tr3gthez,42.5848888487,1.21501184787,63,19,82
brody,42.4974347732,0.948220886763,189,59,248
lowww,42.1646429867,1.35116197752,53,11,64
gyaki,41.9739707313,2.63920299007,11,2,13
revan,41.9526594945,1.16356437086,65,22,87
hiyo,41.6739361239,2.69303171939,9,2,11
yu-kun,41.6386998661,3.05305557737,5,2,7
taimai,41.2082288666,2.99768645273,5,2,7
stranded,40.8647033915,1.214608244,63,19,82
lord narwhal,40.1609132805,1.18168184927,60,20,80
dtan,40.1602216299,1.50210476946,27,12,39
robert,40.0232732272,1.31094081219,44,15,59
jaimehr,40.0028592862,1.20461258939,56,23,79
bloodpeach,39.9284746171,3.19693967422,9,2,11
tavomono,39.8035811352,2.6464679859,9,3,12
firo,39.6539131359,1.4609200934,35,14,49
cobr,39.5464202119,1.29702587557,45,18,63
hammerheart,39.1465594478,1.26050793804,55,18,73
kort,39.1375003161,1.73563126647,26,10,36
shalaka,38.9846966549,1.67021921772,27,11,38
derek #squats,38.8419594233,2.13064325542,11,5,16
czar,38.5740154067,1.68458011695,28,9,37
banze,38.5738127634,2.4543127245,11,5,16
ctg,38.5073076635,1.02853251268,94,36,130
heropie,38.458430452,1.87850204961,20,7,27
hero pie,38.3637825607,1.97292104491,18,8,26
kd3,38.340528452,1.05818332083,83,27,110
fireblaster,38.1765128857,0.938974730676,138,53,191
star king,38.1129856541,1.26395691074,50,20,70
nacl,38.0580994329,1.35170793762,43,18,61
handsometom,37.739413889,2.02998448054,14,8,22
kimimaru,37.637506494,1.55907188198,29,14,43
clubbadubba,37.6309419219,1.57105376648,30,12,42
sheermadness,37.6280528742,1.87966270716,18,8,26
combo blaze,37.5740809936,1.45728672561,37,16,53
manjaro,37.5553081975,3.14556706974,8,3,11
cesar,37.378978761,2.87858307281,7,3,10
josh brody,37.3037904294,3.07083887185,8,3,11
bonobono,36.9965762617,3.29635424318,5,2,7
janitor,36.7581448486,1.30449143322,51,21,72
janco,36.7111776585,1.73615009376,21,12,33
nta,36.665728224,1.72762256887,23,10,33
kyle tree,36.5324283241,1.90961875828,18,10,28
marbles,36.456885561,1.13610664207,60,26,86
ybombb,36.2266540218,2.22444808384,12,8,20
loto,36.2054812225,1.19689821137,46,23,69
stevie g,36.1501226436,1.37023708486,40,14,54
skg,36.0991827148,1.27538739508,36,18,54
shears,36.052845183,0.934408588333,146,66,212
finio,36.0521295931,1.24292257944,44,21,65
nintendude,35.8163279486,1.19782499312,53,29,82
yunque,35.806715407,1.46658191565,31,15,46
darkhorse,35.6579761386,0.942679896768,104,56,160
horbie,35.5122186764,1.16561979092,61,29,90
greginator,35.4648157211,2.77732187328,7,4,11
roman,35.4629134415,1.51235376606,34,16,50
lorenzo,35.3274075867,1.65834629705,24,11,35
hydra,35.3206856057,1.70447327731,23,11,34
fumbles,35.0196406832,2.14885668011,14,6,20
nothing,35.0178450691,2.24135050833,14,6,20
sotoh,34.8975142933,1.4610955257,33,19,52
blondekid,34.8960136066,1.72493137526,22,11,33
purple circle,34.8025447402,2.83684799465,12,4,16
jason,34.7993191982,1.63770730374,26,12,38
jose,34.7254116834,2.58414682422,8,4,12
amida,34.6764205455,2.26888997825,12,7,19
vinsanity,34.5795785498,1.87132517742,16,8,24
hotline,34.5492347035,1.66359400706,21,11,32
fray,34.4615772063,3.36125901991,3,3,6
$$$ jim $$$,34.4212506284,1.4350960806,32,16,48
letsgo,34.4202045025,1.82818183051,19,12,31
daniel,34.3635757102,1.6279651544,21,14,35
jam,34.3296612866,2.58604899536,8,5,13
dark gentleman,34.2971321748,1.16906028447,50,26,76
supa,34.2888480538,1.60135431745,22,13,35
antwon420,34.099418643,1.85186792682,16,9,25
sax,34.083136039,2.41080870519,10,5,15
gravyfingers,34.0738381778,2.04716095918,17,8,25
yobo,34.0603734097,1.12703649519,54,32,86
freean,33.8883763567,1.32222911589,37,21,58
connor,33.8882523045,1.93213558094,20,10,30
the ki of chaos,33.8826375212,5.88909861289,1,0,1
eg,33.8659905408,1.47534896895,28,16,44
james3927,33.6215403357,2.52588783201,11,4,15
masterhandjob,33.5548061428,1.11187056775,54,30,84
hipstur,33.5194710417,1.22289772901,51,25,76
wookiee,33.5186750369,1.33219404961,37,22,59
b link,33.4210302855,3.4233122782,4,3,7
time machine,33.4153787899,1.85147119049,19,10,29
fruity,33.3842609723,3.52964125008,5,2,7
madrush,33.3807038984,1.01460332247,70,49,119
pugs,33.3442206124,1.26115423692,35,24,59
butt solo,33.3123157629,3.84667538688,3,3,6
schickler,33.3089452799,2.59025281941,9,4,13
satan [turner],33.3043093714,3.29711714346,4,3,7
gilkaoz,33.2955617545,3.25988878176,6,4,10
fishaman p,33.2740791831,2.40097978322,9,6,15
sextc,33.2545672866,1.62298865146,21,16,37
raychu,33.2517893531,1.24352939613,47,22,69
dajjal,33.2443632493,1.71509996796,22,13,35
facechew,33.1235160338,3.94508944253,5,2,7
cover,33.029345589,3.19584515887,5,4,9
timemachine,33.0192882274,1.57430671083,25,16,41
sedda,33.0079579138,1.35573655342,36,20,56
near,33.0055112562,2.16030544077,12,8,20
zeppelin,32.9315705413,3.10089909277,5,3,8
smash jesus,32.879494365,2.29338045438,14,6,20
monte,32.8751265082,1.92198023903,15,6,21
bo,32.8736448558,2.00089987543,14,9,23
indefa,32.8598360405,1.93582916357,19,9,28
sunnyb,32.7879977522,3.56449745895,4,3,7
the protagonist,32.7577733028,1.1648956926,50,32,82
andykins,32.6930992569,1.53863390749,25,13,38
mojomonkey,32.6715715464,2.20157269912,12,7,19
dr. grin,32.6505908218,1.88966501396,17,12,29
dogs_johnson,32.6452565265,1.19052022798,48,28,76
mr.sir,32.639519755,1.11650117622,55,35,90
cyoonit,32.5928244628,1.87070429326,14,10,24
preston,32.5882294995,1.33939322829,38,22,60
nickelbackstreetboy,32.5524121722,3.54630563083,4,2,6
shihman,32.547309428,1.30642696385,42,25,67
j.moosh,32.5088461784,2.80536117068,9,4,13
the big d,32.407643044,4.09802043876,4,2,6
poobearninja,32.4037778794,2.84303906931,9,4,13
stonefallow,32.392499565,3.49415537303,6,4,10
jay_mute$,32.3352192373,1.6850352406,20,12,32
th3kuzinator,32.2195835115,3.33454023191,6,4,10
dishier wand,32.1755342664,1.38561923315,31,23,54
subtle,32.1022101287,2.33342536219,13,9,22
the dark gentleman,32.0509317121,3.552146823,4,3,7
gildo,32.0430277085,1.54964373996,27,14,41
eggmode,32.0074834788,2.10372499678,13,11,24
b0n,31.9822767556,3.9641478883,4,2,6
jay-r,31.9808715192,1.52871743015,26,15,41
weedwack,31.9608215976,1.56929537323,21,17,38
knitephox,31.9450771041,2.41855201508,10,7,17
dogg,31.9213758108,2.58725412792,8,6,14
snorlax,31.9190936296,1.9523394538,15,10,25
ken,31.8110244458,5.40169263758,2,1,3
elel,31.7998423142,1.5420213479,28,18,46
spongy,31.7674932519,1.25627034889,39,22,61
bp,31.6496587157,2.2021169421,11,7,18
spark,31.6297182442,2.75594821915,7,4,11
qapples,31.6062415783,1.32828048865,32,26,58
socrates,31.5945871293,2.51331672615,7,6,13
battlecow,31.5939869488,3.4016171486,4,3,7
tank,31.5845168338,2.47794056868,10,7,17
bard,31.5791427122,1.27445073,35,28,63
d35,31.547098696,1.50198669172,26,18,44
nattybroh,31.5369189623,2.65377269796,9,4,13
kirbstomper,31.5188344006,3.86445858352,4,3,7
moosh_da_moosh,31.4932991785,2.09129503201,14,8,22
dr. lampy,31.2202652854,1.62097547472,18,12,30
commander,31.219157037,4.42278572814,3,2,5
a to the z,31.2052346468,2.11350234695,11,10,21
josephzander,31.1977877538,3.43202608064,5,3,8
q!,31.1890681704,1.28638633203,38,28,66
deathcpo,31.175071837,1.2181222217,39,30,69
komotonoto,31.1552590208,2.27911929148,11,7,18
g0d,31.1403348642,4.50048660197,2,2,4
rossi,31.1312028168,4.20548682927,3,2,5
pete,31.0990824104,3.62685915722,4,3,7
tyhiggz,31.0508793082,1.18496714394,43,30,73
saltsizzle,30.9991284367,1.73436376277,17,13,30
studstill,30.9310670975,3.00777583832,7,4,11
se√±orhen10r,30.9144605913,2.75916580413,7,5,12
ivor,30.8866197892,4.09947611008,3,2,5
kaz,30.8787766238,1.15512361064,51,31,82
jimmy joe,30.8620166728,1.08016299837,46,45,91
fck vwls,30.8185201649,2.26392949062,10,11,21
shanks,30.8108401106,2.93696326187,6,5,11
gunnermaniac,30.7996351092,1.97522988341,12,10,22
miniohh!,30.7363897015,1.64716045246,20,13,33
tot,30.6935093983,3.09561865676,7,6,13
paco,30.6645006157,1.32272081905,34,26,60
a$,30.6298077569,2.35960263694,10,6,16
limesoda,30.5857601305,1.65929072904,21,15,36
dubs,30.5848088535,3.18209149888,7,4,11
rusty,30.5584416417,1.22633355354,34,28,62
zeozen,30.5301441479,3.9694387163,4,3,7
jamjar,30.4704727816,1.08694515984,53,43,96
bowl,30.434929778,1.64055471311,19,17,36
scoback,30.4322981639,2.44870781797,9,9,18
joker,30.4195883439,4.03115445444,2,3,5
skyfire,30.410056034,1.82749832256,14,12,26
bread,30.3900587325,1.74168478421,17,15,32
natty,30.374758093,2.78582532052,7,4,11
american patriot,30.1714781172,2.34734550915,8,5,13
korobeniki,30.1605744748,1.27582700243,38,28,66
the (.)(.),30.1449068231,2.39558508296,9,7,16
captain l,30.1253448971,1.89483216256,14,15,29
pizza jokes,30.0652482018,3.5232769921,3,3,6
captain fabulous,30.0567429156,1.59802689842,23,18,41
emptyw,30.0198966211,2.6737135197,8,5,13
rith,30.0135657531,3.90958200199,3,3,6
llcstoism,29.9871433075,1.7223016883,17,15,32
yoleo,29.9626445297,1.93609691699,13,12,25
fancy,29.9518204603,4.24685236426,3,2,5
nyx,29.9494425668,3.21782119349,5,4,9
mokkori,29.9221620874,4.18659466566,3,2,5
bon,29.8968648388,2.19041517656,11,12,23
onski,29.8860468563,1.49985145221,25,24,49
bt,29.8362700339,2.17060493188,9,8,17
moogle,29.8328805413,4.33168728203,3,2,5
b33f,29.8139067765,1.35446289968,30,21,51
v,29.7870601431,1.37512199278,29,25,54
heny935,29.7663175994,3.94718579012,4,2,6
bert,29.6917895561,4.01561188787,4,3,7
olbus,29.6873857057,3.96253024585,4,2,6
daniels,29.6642330207,1.47125483821,27,20,47
crockett,29.6593502949,2.44639525472,8,6,14
spamus,29.658400278,1.3079119956,30,28,58
razz,29.6389366349,1.04282002595,61,46,107
lob,29.6153154591,2.58715562131,7,5,12
mr. wang,29.6048887164,4.10245695982,4,2,6
reptar,29.5660539857,1.29831597106,34,27,61
sheick,29.5603697513,3.13764652672,6,5,11
m-angry,29.5526560118,3.08278293788,6,4,10
pewpewu,29.5103717779,3.04433697029,8,5,13
quitrage,29.4900048724,3.26730890649,5,4,9
wincancel,29.4832848652,2.66464706527,8,6,14
umbra,29.4752212703,3.27260665752,6,4,10
the american patriot,29.4373245494,4.21048447834,4,2,6
piratetrips,29.4211027898,2.81001356653,7,4,11
stingers,29.39583202,7.17147558733,1,0,1
sampai,29.39583202,7.17147558733,1,0,1
blue,29.39583202,7.17147558733,1,0,1
dublat,29.39583202,7.17147558733,1,0,1
sarge,29.39583202,7.17147558733,1,0,1
charky,29.39583202,7.17147558733,1,0,1
rocket,29.3674753054,1.33895413366,28,25,53
greeno,29.3626171226,1.65835641151,23,15,38
newbtube,29.3522992578,2.72147981358,5,5,10
jxc,29.3356147117,2.11546978671,11,8,19
annex,29.3355404566,1.8061013205,18,14,32
logic,29.3288888622,2.09986042812,10,8,18
thord's bro,29.3099186818,3.13392301356,5,4,9
zuber,29.3062360858,3.47379354525,3,5,8
natendo,29.2832778098,2.06466867723,12,8,20
reefybeefy,29.2829013198,1.82506189525,14,13,27
0prah,29.2742120919,2.85021320542,6,6,12
t-beau,29.27115413,2.79022602183,7,6,13
morino,29.2260895886,3.85461294267,3,3,6
dizzle,29.2157236769,1.3759718362,26,27,53
bigfish,29.1439421558,2.72499354174,6,5,11
aerosheep,29.1146613939,3.97499806149,4,3,7
mustard tiger,29.0995072215,3.32198432043,6,4,10
repsguy,29.0773797364,4.87212257673,1,1,2
nesskhalifa,29.063478124,1.74919438554,16,16,32
toro,29.0095603006,4.38928209674,3,2,5
touque,28.9823537595,4.27259275633,3,2,5
kyle,28.9761097646,2.56548165727,8,6,14
chet dunskies,28.9713957389,3.43368722084,5,3,8
duffman,28.9576994666,4.44491789939,3,2,5
fil,28.9357191854,1.31869574944,29,30,59
allgreen,28.9310212199,2.44716625223,7,6,13
king lumsy,28.8941501732,2.6545371754,7,6,13
broly,28.8374272901,4.38916703232,3,2,5
gt,28.7861525586,0.920644909347,92,84,176
backes,28.7759781371,4.48573362877,2,3,5
elvis,28.7587498633,4.26553689379,3,2,5
pathall,28.7271970168,4.69344711303,2,2,4
a la carte,28.6131211007,3.55538815759,5,4,9
fenrir,28.5878136349,4.65689499247,2,2,4
kelvinheit,28.5837195135,1.43540891211,29,19,48
breakthrough,28.5501511304,1.94530091182,13,14,27
birdlordmasterbeak,28.5429251864,7.1211258753,1,0,1
zuko,28.4817039567,1.94141254968,16,14,30
cam,28.4617495532,1.9797713032,10,12,22
yrn,28.4390595981,2.08097929729,10,10,20
epic!,28.4168248835,3.01700865869,6,4,10
darkneon,28.4157960148,4.4070657674,3,2,5
purtle,28.4149202549,1.96260817134,12,12,24
fenlet,28.3531410488,4.74221262979,2,2,4
phut,28.3223415456,3.99197197983,3,3,6
tvdonk,28.3203937299,4.45958674045,3,2,5
smurf,28.3136998892,1.26727682168,41,32,73
ibc,28.3130419186,3.36281447405,4,4,8
coin chaser,28.2990279648,4.40912520839,3,2,5
tonester,28.2582675541,2.04968010413,14,10,24
slappypoopy,28.2570795941,1.58477062215,22,18,40
blaise,28.2055181803,4.52219949795,3,2,5
peasantloaf,28.1958652619,4.26248928484,3,2,5
bloogo,28.195786042,1.14639807746,39,37,76
jsmirk,28.183070174,1.51204190051,26,22,48
autobaun,28.1529055021,4.53845634446,3,2,5
bacorn,28.1436498056,2.47567422153,9,9,18
nattyb,28.1340321176,4.41412338,3,2,5
cody,28.1079878626,4.80341895596,3,2,5
toronto joe,28.0996945701,4.53051547838,3,2,5
batterybird,28.0646892936,4.53376969681,3,2,5
kraines,28.0154055579,4.8746850721,3,1,4
sebula4,27.9711233548,4.45140829467,3,2,5
mr. slimey,27.8861676951,4.73510882063,2,2,4
box765,27.8830104424,1.38282744705,21,25,46
therm,27.8799438162,3.65077399119,4,4,8
anotherish,27.8480172074,4.74511802982,3,2,5
enneielle,27.8195884603,3.84402021199,3,3,6
taiko,27.7901482209,2.48686928205,8,9,17
kriskringle,27.7889760143,2.88319198789,6,5,11
dragoniota,27.7660977373,4.48734501111,3,2,5
professor_wizard,27.7592425819,1.42826103322,29,22,51
xor,27.7306959177,4.55622523955,3,2,5
automatic,27.7285794156,1.63936244208,16,19,35
dam_tewton,27.7241936981,2.09865787824,11,12,23
bamster,27.7020032046,2.96352331232,6,6,12
maliki,27.6889354517,2.07961389296,13,11,24
zyrg,27.6875599983,3.14537362783,5,4,9
xyk,27.6764184763,4.4512066855,4,2,6
waxy:joe,27.6705054086,1.34287753989,24,25,49
rishi,27.6481480454,5.64922056687,2,2,4
velocity jones,27.6371442303,1.21601168392,34,34,68
kabal,27.625076721,3.87756274923,4,3,7
marlwolfe,27.552619447,3.82671112369,3,3,6
quickcav,27.55040182,3.25546867637,5,3,8
shake,27.5437641035,2.75035275832,6,7,13
hack,27.5303137369,1.65816321509,19,17,36
t0mmii,27.5268971516,4.50511998972,3,2,5
duff man,27.5153936499,1.92068500124,12,14,26
viberant,27.4944098214,2.45630347169,8,7,15
maniac379,27.426503267,1.31521768944,31,33,64
r6=s2=(sr)2=1>,27.3948313936,3.74717188351,3,2,5
darv,27.3876453993,2.29687200915,9,10,19
my buddy mike,27.3630733325,5.18234526133,2,2,4
fake,27.3105947422,3.34945166795,4,4,8
toa,27.3054941163,5.42810815745,2,2,4
beans,27.2937433822,1.70942527764,18,15,33
dpb,27.2936032517,4.60076381324,3,2,5
ern,27.2752491302,4.52152801546,3,2,5
1000,27.2336915033,5.26256748611,2,2,4
maze,27.172451722,4.91922946636,2,2,4
ringedge,27.1717996833,1.57517705376,20,16,36
p21/c,27.1678415028,1.87839574735,13,15,28
okuser,27.1126150149,2.21217464156,8,10,18
pizza,27.0833142816,1.52004975065,23,25,48
meromorph,27.0514327414,5.01282557447,2,2,4
inukem,27.026715172,2.79953694738,4,6,10
freddy cougar,27.0208363255,5.4314485912,2,2,4
sunflower,26.9774891843,1.37955305381,25,28,53
jnatty,26.9546008372,3.09697157793,6,6,12
vudujin,26.9460054325,4.79897904172,2,2,4
mr.watchandlearn,26.8453200038,5.13273670901,2,2,4
the yid,26.834835294,1.14898276939,42,45,87
vanddar,26.812335727,4.90847115312,2,2,4
big dick damage,26.7879676664,3.23181107142,4,4,8
cam2,26.7784474517,2.33985652958,7,8,15
cwic-beam,26.7620144169,1.93024634128,14,14,28
kaladin,26.7588062893,4.84757461904,2,2,4
flanders,26.7430632993,2.78693123297,7,5,12
walkrofsky,26.7130959207,1.7599115722,12,17,29
fudgeball,26.6801323654,4.1606982305,2,2,4
no~m,26.6769190388,2.79201131155,7,6,13
rizner,26.6693449304,1.92361847983,14,14,28
maps,26.6618022826,1.50271613939,20,21,41
blue lantern,26.6388503547,4.90941010526,2,2,4
shyboy,26.6343030405,4.82060840724,2,2,4
sav,26.608396638,2.34370017477,8,7,15
el man,26.5783422815,2.59658385798,7,5,12
synth,26.5707186862,4.42243348254,2,2,4
salami,26.564232843,3.05697175652,6,5,11
hoofy,26.5462089494,1.55135970302,23,22,45
oh thomas,26.4593809216,4.31001084556,3,3,6
dad,26.4592502361,2.89147201633,7,5,12
whitejesus,26.4347824408,1.23407388937,30,36,66
nalgas,26.4324148357,4.52154689818,3,2,5
mando,26.4321528081,2.17388922337,10,13,23
killahertz,26.3643937395,3.04031012948,5,6,11
gooby,26.3219461327,2.78081592698,6,7,13
stonehaus,26.3144683052,4.85649340991,3,2,5
thomdore,26.2865944065,5.07773647171,2,2,4
white,26.2127601873,4.45860810546,2,3,5
hhhhhhhhhhhhhhh,26.1805605948,4.94442759964,2,2,4
cam1,26.1632476902,2.5223607391,8,7,15
king funk,26.1531776864,4.1156138054,2,3,5
k rool,26.1371067695,1.65570739867,16,21,37
hypa,26.1258403992,4.79492866376,2,2,4
stew,26.1225085555,1.30196363349,32,34,66
droc,26.0804712098,1.36951780721,24,29,53
shishkabobs5,26.0718708003,5.37780397789,2,2,4
superderekfan,26.0646050453,4.69936439929,2,2,4
flatvi,26.0320048839,4.22536384178,3,3,6
ham,25.9714066611,1.83782423641,13,16,29
toxic,25.9652656811,1.89147884712,13,11,24
boomalready1,25.9453830841,3.75152378119,3,4,7
bringdaruckus312,25.8961482234,4.91181907561,2,2,4
mortech,25.8698498732,1.68446528527,17,19,36
bigbeaver,25.8351307352,1.30522791929,26,34,60
collin,25.8013061904,2.28148112518,9,9,18
bunz,25.7855859158,2.19734565254,11,15,26
cmull,25.7646158657,3.4504720971,3,4,7
hoofydough,25.7113062928,4.91600928402,2,2,4
traiman,25.6805275611,1.95940646267,11,14,25
baby legs,25.6725668052,2.56486870641,7,7,14
lookalike,25.6377991163,3.68278876889,4,4,8
ace,25.6087304197,1.60157430239,16,21,37
webwipe,25.6065340519,3.3842136928,3,4,7
le_vinny,25.5966217441,3.31586859962,4,4,8
z-rex,25.5951636431,2.71218105109,5,8,13
blmb,25.5880881676,4.747683894,2,2,4
meerkat,25.5830177788,2.38833218394,9,10,19
komodoninja,25.5795968181,2.70206934809,8,5,13
scratch,25.5788532111,1.86902867637,13,16,29
sebula,25.5768992485,1.26448181377,29,35,64
j9d2,25.5678331018,4.26488499498,2,2,4
tbq,25.5638398329,3.35544412538,4,4,8
chuck lubs,25.5606773425,5.02116683742,2,2,4
hariballz,25.5320289049,3.41696308649,4,4,8
kirbyrocket,25.5277089448,4.31463196514,3,2,5
prime,25.5163517546,1.67201468878,17,17,34
funkykong,25.5050742126,4.87107097566,2,2,4
justin,25.4628768539,2.692635295,7,6,13
mixxedvegetables,25.4501743805,4.70204997659,2,2,4
ttt,25.4464256048,3.0113221445,3,6,9
jlo,25.4120316069,4.81805105085,2,2,4
snowstorm,25.3934923152,4.93156978565,2,2,4
griffith,25.378514439,1.38179025505,22,28,50
t brett,25.3671626614,3.85884397536,3,4,7
starchild,25.3611312572,2.95232769534,6,6,12
nasian,25.3404237394,5.74907458247,1,1,2
therapture_,25.3258278266,5.13054155253,2,2,4
salt,25.2941591503,4.96321040971,2,2,4
purple fox,25.2890644797,4.58709452422,2,2,4
sunvulcan,25.2848538707,1.544258086,21,19,40
wazzberry,25.2821512309,4.73421942984,2,2,4
cortese187,25.2734327832,4.80713072026,2,2,4
swiftbass,25.2622368269,4.89216411198,2,2,4
h2o,25.2593669871,4.85995252983,2,2,4
zhu,25.2570917719,5.15198224649,1,2,3
log,25.2568480764,2.95093807272,4,6,10
klms,25.2540556461,4.9265753216,2,2,4
zbl_mystic,25.2424725068,5.22739906805,1,2,3
blisstex,25.2367846779,2.95958643614,6,7,13
pandemonium,25.220578387,4.55214797812,2,2,4
slappymcnutz,25.1768192385,1.85002822486,11,18,29
giraphe,25.1767537615,4.8547062007,2,2,4
wowzers,25.1586957156,4.68073409761,2,2,4
doughnut,25.1365856073,4.90359889234,2,2,4
qubit,25.1257493202,4.91426923128,2,2,4
karlthemarx,25.1124033326,4.8206721687,2,2,4
leavescat,25.0993709433,3.5385561854,4,4,8
poptartplug,25.0826285291,5.11818158289,2,2,4
iheartqueso,25.0806054411,2.64981427053,8,9,17
damp,25.0462356422,4.82420329543,2,2,4
notlightningrunner,25.0432425227,4.65308130371,2,2,4
tom bombadil,25.0319377638,3.27608010765,4,5,9
beguiler,25.0181002617,5.04179208223,2,2,4
measthebeast,25.018073698,2.09158511214,9,10,19
flat nat,25.0,8.33333333333,0,0,0
branchan,25.0,8.33333333333,0,0,0
snazzy,25.0,8.33333333333,0,0,0
jeremy,25.0,8.33333333333,0,0,0
bulldog,25.0,8.33333333333,0,0,0
urpasmash,25.0,8.33333333333,0,0,0
k-phat,25.0,8.33333333333,0,0,0
falln,25.0,8.33333333333,0,0,0
mickeyrat,25.0,8.33333333333,0,0,0
thac0,25.0,8.33333333333,0,0,0
the amazing busterino,25.0,8.33333333333,0,0,0
link,25.0,8.33333333333,0,0,0
paul d,25.0,8.33333333333,0,0,0
locamash,25.0,8.33333333333,0,0,0
hypertj,25.0,8.33333333333,0,0,0
aperture,25.0,8.33333333333,0,0,0
moft,25.0,8.33333333333,0,0,0
deep dimples,25.0,8.33333333333,0,0,0
astumpyzombie,25.0,8.33333333333,0,0,0
l0n3r,25.0,8.33333333333,0,0,0
s≈çcrates,25.0,8.33333333333,0,0,0
brendanhall,25.0,8.33333333333,0,0,0
vio,25.0,8.33333333333,0,0,0
adubz,25.0,8.33333333333,0,0,0
goomah,25.0,8.33333333333,0,0,0
jobook,25.0,8.33333333333,0,0,0
werewyatt,25.0,8.33333333333,0,0,0
mojn,25.0,8.33333333333,0,0,0
dezno,25.0,8.33333333333,0,0,0
phex,25.0,8.33333333333,0,0,0
mimi,25.0,8.33333333333,0,0,0
jarl,25.0,8.33333333333,0,0,0
filet,25.0,8.33333333333,0,0,0
rudedude,25.0,8.33333333333,0,0,0
redeagle2000,25.0,8.33333333333,0,0,0
chai,25.0,8.33333333333,0,0,0
pastor,25.0,8.33333333333,0,0,0
dunos_,25.0,8.33333333333,0,0,0
bird-dawg,25.0,8.33333333333,0,0,0
core,25.0,8.33333333333,0,0,0
sheen,25.0,8.33333333333,0,0,0
wolfcry,25.0,8.33333333333,0,0,0
eltiti,25.0,8.33333333333,0,0,0
masterofzoroark,25.0,8.33333333333,0,0,0
price,25.0,8.33333333333,0,0,0
lunchy,25.0,8.33333333333,0,0,0
sd master,25.0,8.33333333333,0,0,0
spaff,25.0,8.33333333333,0,0,0
hail_sagan,25.0,8.33333333333,0,0,0
spicky,25.0,8.33333333333,0,0,0
sussebass,25.0,8.33333333333,0,0,0
pilot,25.0,8.33333333333,0,0,0
fractal,25.0,8.33333333333,0,0,0
brentosfreshness,25.0,8.33333333333,0,0,0
sharktoast,25.0,8.33333333333,0,0,0
sabo,25.0,8.33333333333,0,0,0
juno,25.0,8.33333333333,0,0,0
pat,25.0,8.33333333333,0,0,0
birdybirds,25.0,8.33333333333,0,0,0
imperium,25.0,8.33333333333,0,0,0
benb,25.0,8.33333333333,0,0,0
sambo,25.0,8.33333333333,0,0,0
magitech,25.0,8.33333333333,0,0,0
djltheescapade,25.0,8.33333333333,0,0,0
rice,25.0,8.33333333333,0,0,0
acestarthe3rd,25.0,8.33333333333,0,0,0
royeric,25.0,8.33333333333,0,0,0
4sk,25.0,8.33333333333,0,0,0
tdx,25.0,8.33333333333,0,0,0
sleeh,25.0,8.33333333333,0,0,0
voidstar,25.0,8.33333333333,0,0,0
da_bear,25.0,8.33333333333,0,0,0
mahie,25.0,8.33333333333,0,0,0
the cfb,25.0,8.33333333333,0,0,0
awesomethesauce,25.0,8.33333333333,0,0,0
mouse,25.0,8.33333333333,0,0,0
spade,25.0,8.33333333333,0,0,0
tweli,25.0,8.33333333333,0,0,0
magnus combosen,25.0,8.33333333333,0,0,0
neverpullout,25.0,8.33333333333,0,0,0
oljace,25.0,8.33333333333,0,0,0
[stg] overload,25.0,8.33333333333,0,0,0
chewy,25.0,8.33333333333,0,0,0
big d [hamiel],25.0,8.33333333333,0,0,0
stephanie,25.0,8.33333333333,0,0,0
puddn,25.0,8.33333333333,0,0,0
king lui,25.0,8.33333333333,0,0,0
nokto,25.0,8.33333333333,0,0,0
bus,25.0,8.33333333333,0,0,0
emon,25.0,8.33333333333,0,0,0
ferrero64,25.0,8.33333333333,0,0,0
monk,25.0,8.33333333333,0,0,0
fireberts,25.0,8.33333333333,0,0,0
reb,25.0,8.33333333333,0,0,0
hans_mawell,25.0,8.33333333333,0,0,0
marfslayer 3000,25.0,8.33333333333,0,0,0
ozymandias,25.0,8.33333333333,0,0,0
ubll black mage,25.0,8.33333333333,0,0,0
little bill,25.0,8.33333333333,0,0,0
esuma,25.0,8.33333333333,0,0,0
flash,25.0,8.33333333333,0,0,0
dobermen?,25.0,8.33333333333,0,0,0
xbc30ep450,25.0,8.33333333333,0,0,0
bronze_sun,25.0,8.33333333333,0,0,0
yung,25.0,8.33333333333,0,0,0
pvc,25.0,8.33333333333,0,0,0
da bear,25.0,8.33333333333,0,0,0
karl,25.0,8.33333333333,0,0,0
ldz,25.0,8.33333333333,0,0,0
afro,25.0,8.33333333333,0,0,0
scuttlebug jamboree,25.0,8.33333333333,0,0,0
k8,25.0,8.33333333333,0,0,0
baedough07,25.0,8.33333333333,0,0,0
gaon!,25.0,8.33333333333,0,0,0
bedgar,25.0,8.33333333333,0,0,0
refriedjeans,25.0,8.33333333333,0,0,0
rf!,25.0,8.33333333333,0,0,0
dr. light,25.0,8.33333333333,0,0,0
nikku,25.0,8.33333333333,0,0,0
god,25.0,8.33333333333,0,0,0
foxnard,25.0,8.33333333333,0,0,0
duckpimp,25.0,8.33333333333,0,0,0
travkid,25.0,8.33333333333,0,0,0
thomas,25.0,8.33333333333,0,0,0
electricgazelle,25.0,8.33333333333,0,0,0
squallette,25.0,8.33333333333,0,0,0
purplefox,25.0,8.33333333333,0,0,0
redribb0n,25.0,8.33333333333,0,0,0
patty-wagon,25.0,8.33333333333,0,0,0
smashlopez64,25.0,8.33333333333,0,0,0
miken,25.0,8.33333333333,0,0,0
johnnyfight,25.0,8.33333333333,0,0,0
4eyez95,25.0,8.33333333333,0,0,0
bund,25.0,8.33333333333,0,0,0
name,25.0,8.33333333333,0,0,0
grunyan,25.0,8.33333333333,0,0,0
mistertizye,25.0,8.33333333333,0,0,0
lukem,25.0,8.33333333333,0,0,0
malkasaur,25.0,8.33333333333,0,0,0
sylveonbae,25.0,8.33333333333,0,0,0
astumpycow,25.0,8.33333333333,0,0,0
madguy,25.0,8.33333333333,0,0,0
hyperbole,25.0,8.33333333333,0,0,0
zane,25.0,8.33333333333,0,0,0
dude,25.0,8.33333333333,0,0,0
cr0ak,25.0,8.33333333333,0,0,0
coldo,25.0,8.33333333333,0,0,0
levity,25.0,8.33333333333,0,0,0
tootmoses,24.995088428,4.06901439721,3,4,7
sandman,24.9887255082,4.55877458215,3,2,5
village mascot,24.9722790988,2.21787089397,11,14,25
imdabes,24.9544618082,4.9329171002,2,2,4
yass2queen,24.9521629583,5.55029356187,1,2,3
lou_sanus,24.9449462888,1.45646475033,21,24,45
biz,24.912197087,3.49623247845,3,4,7
dr.yonz,24.9094538465,3.02118817576,4,4,8
jc_chill,24.8816904935,4.66007647926,2,2,4
hayrow,24.8760716524,5.60963176016,1,2,3
pintoa,24.8575746236,2.52235247553,8,9,17
alex,24.8440112742,3.9427675759,3,5,8
shaddi,24.8273228133,2.776624366,6,6,12
olikus,24.8187308276,4.4885739149,2,3,5
dasit mane,24.8054783952,5.29757846679,1,2,3
pidgezero_one,24.8030371179,4.92260328023,2,2,4
7blanks,24.7857655914,4.03426846924,3,3,6
vanillarin,24.7809754632,3.89355343093,3,4,7
yeye,24.7742728342,4.27205373497,2,4,6
tafokints,24.7481474278,5.98106833786,1,1,2
schmerka berl,24.6966051069,2.51962335631,7,11,18
daddy's milk,24.6676852937,4.12856222723,3,4,7
blueman,24.6573248346,4.14654812795,3,4,7
soulbroker,24.6490965711,4.77612071047,1,2,3
dankestdad,24.6437415848,3.67614204639,4,4,8
barron,24.6388741113,5.14153367566,2,2,4
tetsu0,24.6262993259,5.03796166079,2,2,4
handles,24.6126914037,2.10961597326,10,11,21
dount,24.6060569127,4.09402006283,3,3,6
mmneggs,24.5976557766,3.37718265595,2,6,8
whuck,24.5828430357,4.01651529369,2,3,5
drinkwildturkey,24.5679881892,3.37974769964,4,4,8
et,24.5647833494,1.87066939318,10,18,28
thissidedown,24.5513665815,5.43925573599,1,2,3
tmakk,24.5249790204,3.24617068526,5,6,11
aces,24.5073475022,2.62233184478,6,11,17
fanboy,24.4889711,5.72519963919,1,2,3
cashhole,24.4833828964,5.40974605277,1,2,3
collin the conqueror,24.4582480014,5.06356359914,2,2,4
satch,24.4484190474,5.04404046701,2,2,4
dusttin,24.4416229571,2.2070821565,10,13,23
pettanko-senpai,24.3961117444,2.66192315016,7,6,13
luigikid,24.395412051,5.00117031287,2,2,4
jazzy jinx,24.3888989225,4.61063078292,2,2,4
hotpocket,24.3812287887,2.48592655917,8,10,18
chicken,24.3302488377,2.98041735151,5,7,12
tauvalian,24.3283622006,5.04985079081,2,2,4
byff,24.318524259,4.43243152569,2,2,4
reese,24.3021092979,4.43609296046,2,2,4
sombrero,24.2179958312,5.24435673891,1,2,3
esid,24.2124377829,2.14195696259,10,9,19
monkey,24.2031069423,2.03902225066,10,13,23
gamer4life,24.1936988112,4.62671965627,2,2,4
chevrium,24.1841541385,3.68885539175,3,4,7
moist,24.1742036403,4.99802031958,2,2,4
enemajoe,24.1699215812,3.24259462889,4,4,8
smashg0d,24.1473408161,5.37571815839,1,2,3
k-nut,24.1365368992,4.29427694186,2,3,5
david barker,24.1289778633,5.6028320226,1,2,3
skrull,24.0382413029,4.94514045373,2,3,5
drewgong,24.0350192689,1.78470688582,13,16,29
gaggleforce,24.0190110612,5.21367293041,1,2,3
dsj,24.0113666549,2.66962542059,6,6,12
sunshinetk,23.9911996257,4.72938122836,2,3,5
pzero39,23.9810688566,2.11691443055,10,15,25
natural brother,23.9771032387,2.90087897342,5,8,13
jinjo,23.9700897429,5.5704973186,1,2,3
slippypickle,23.9521956363,4.28111321951,2,4,6
kevine,23.9477325873,5.60074788092,1,2,3
costaricancool,23.9301440452,4.56037777054,2,3,5
nuggzy,23.9133660777,4.78267472168,2,2,4
savior,23.903488871,4.95466006915,2,2,4
wubbs,23.8760261292,4.93136586822,2,4,6
ders,23.8729778209,3.70607707358,5,4,9
icho,23.8673601632,4.93374751576,2,2,4
cane ut,23.8555078953,5.4463757157,1,2,3
jaquarium,23.8404794066,5.04087719999,2,2,4
camerino,23.8403473555,4.17764419936,2,4,6
khakis,23.8195168002,4.66275126303,2,3,5
dirtcruncher,23.8081199349,3.34521926927,4,6,10
waldo,23.7825553119,4.19578685754,2,3,5
cmac,23.7515144619,3.29617959404,4,6,10
gaijilla,23.7335000994,5.89458141807,1,2,3
mr. biz,23.7210641953,5.05089869586,2,2,4
monad,23.7159681442,1.50560666746,17,31,48
probers,23.6839741158,4.62700656,2,2,4
truffleshuffle,23.6788769285,4.52693030002,2,3,5
zenaga,23.6761009151,5.50042648943,1,2,3
majin_bukkake,23.6151339994,1.94814699783,11,16,27
puncayshun,23.6000154758,3.56160892133,4,3,7
papaghanoush,23.5974176333,3.54320008452,3,4,7
wheels,23.5724087385,2.18408163322,8,7,15
searing scar,23.5670024475,4.41055471903,2,4,6
izoo,23.5371695413,5.42181231484,1,2,3
capos,23.535371274,1.11926812934,43,54,97
wal,23.5336824981,5.76636514869,1,2,3
b.i.,23.5215419281,1.95766626042,9,13,22
kingkool,23.4944752911,2.48912274418,8,10,18
file,23.4916057988,2.60292667656,8,5,13
arctic,23.4684294881,5.40148296815,1,2,3
chronicmexican,23.4484887934,2.45072406,6,12,18
bre,23.4376222943,2.34344490415,7,9,16
staysleepin,23.4230666918,2.91993571325,4,8,12
sonicfuzz,23.4163903228,2.02959553305,12,15,27
moze,23.381054954,4.99312119924,1,2,3
pochilin,23.3686415636,3.89578154083,3,5,8
rawdog,23.363334365,5.06369679768,2,2,4
steamfriedasian,23.3621246951,5.73391255533,1,2,3
derstuk,23.3536421543,2.16747653727,10,12,22
-philip coast philip-,23.3460507534,5.25167639573,1,2,3
thrillhouse,23.303600899,1.83312856411,11,17,28
gera,23.2851911871,5.48739664317,1,2,3
sph,23.27614359,4.5186933381,2,3,5
bhol,23.1872996358,2.25822442274,8,11,19
neth,23.1861020266,5.49320539377,1,2,3
qtip,23.1471201424,5.96320374501,1,1,2
dwreck,23.1427050378,5.50870913819,1,2,3
grahamaglam,23.130924013,1.93476760833,8,16,24
chino san,23.1303764816,5.42112468584,1,3,4
clefairy as mew,23.0927379524,4.95371121424,2,2,4
bottle opener guy,23.0623334097,3.3632243122,4,4,8
stylisland,23.0568598013,4.88157361091,1,2,3
andy,23.0492091034,3.15738338366,3,6,9
masquerade,23.0480593414,5.50126583567,1,2,3
matt,23.0420960858,3.23666716033,3,5,8
ardent rage,23.0390518825,5.33053236201,1,2,3
bimbo,23.0290082348,2.95033227418,4,5,9
dex,23.011135291,7.26144247377,0,1,1
garv,23.0093845888,3.94328771045,2,2,4
gibbles,23.0012066726,4.98577267753,1,2,3
jaapoh,22.9976890276,3.61373663366,3,4,7
kman,22.9932321123,5.67901093998,1,2,3
minymidge,22.9869701835,2.16273601347,7,16,23
billbacon420,22.9572548408,1.42872087229,20,31,51
ditto,22.9345327682,2.34309442712,7,11,18
ajbcdefg,22.9285394886,1.44055275519,22,29,51
pluto,22.9092643073,5.56218526537,1,2,3
asaaj,22.8760021576,3.29586095066,4,4,8
bean,22.8536975763,1.75262536884,12,25,37
nigel_thornberry,22.8525552656,5.24517339621,1,2,3
leaf fc,22.8507249111,3.24174589732,4,6,10
brny,22.835010313,5.26675091251,1,2,3
sinbad,22.8304218592,5.42109445474,1,2,3
zibba,22.8170969194,7.24300767435,0,1,1
lordtoko,22.7787270381,2.7471611973,5,7,12
dankpank,22.7642724486,1.3644175682,23,33,56
racilor,22.7642655735,4.67739195777,1,4,5
greenblob,22.7564180891,2.92864747565,4,7,11
bflakes,22.7548489685,1.92292379043,11,16,27
duncs,22.7532213568,1.56842590412,20,24,44
dsyr,22.7461808636,4.00198338215,2,2,4
bodacious,22.7456335897,4.10770698892,3,4,7
xanz,22.7216903438,5.09008313622,1,2,3
pupperina,22.7187676475,4.47650003163,2,4,6
bonerstorm,22.7131543348,5.03759629022,1,2,3
goosewithsocks,22.7045380472,1.56396967675,18,23,41
silver,22.7044844349,3.14966393912,4,6,10
verwaltung,22.6867102224,5.67101579923,1,2,3
egg,22.6848235263,7.13555646269,0,1,1
drewskii55,22.6773296708,7.1998936357,0,1,1
crazyk115,22.675195546,5.13123091144,1,3,4
rgood,22.6568814078,5.22740397957,1,2,3
xif,22.6514029781,7.12491104683,0,1,1
aisengobay,22.6281627487,5.02165362371,1,2,3
boh,22.6263883891,5.22409885802,1,2,3
nanagens,22.6262182677,2.84251555053,7,5,12
cooljoe,22.6161343304,5.22917378086,1,2,3
foda,22.6059190759,1.94824065795,11,14,25
cyan can,22.5966233781,3.56980988199,3,6,9
hotahota,22.5784844703,2.74083403136,7,7,14
cuppajoe,22.5614711416,3.98912966001,3,4,7
evals,22.5497261156,5.26109394584,1,2,3
zhao_guang,22.5456052951,5.28429463475,1,2,3
robnu,22.5361970475,5.27291984814,1,3,4
schlag,22.5295736344,5.64093463869,1,2,3
keagsbsmashin,22.505682607,4.93161471885,2,2,4
lldl,22.4754387364,5.54602983821,1,2,3
momdameatloaf,22.4742043083,2.75441216389,5,6,11
bohemian milk,22.4410234019,5.64191828862,1,2,3
mourin,22.436189438,5.53322447519,1,2,3
rythemretrn,22.4257927027,5.54390698698,1,2,3
okay,22.419978888,5.79943566461,1,3,4
hsf,22.3577182729,5.21749074515,1,2,3
bombproof,22.3560142361,3.12527636874,4,7,11
tokaji,22.3418384892,5.72549549374,1,2,3
the professor,22.3357851457,3.93517245049,3,5,8
zergos,22.331769165,3.2809092495,4,6,10
panda,22.326594652,2.87040193008,5,9,14
maaron,22.3235126558,5.2279102694,1,2,3
rebel scum,22.3120968499,3.35281578104,3,5,8
milleneum,22.3054115849,2.66527550497,5,10,15
green eggs and spam,22.295213849,3.98142251599,2,4,6
yakal,22.2950630033,5.45881954507,1,2,3
widdy,22.2946756318,1.77301313695,14,27,41
sun vulcan,22.2630109463,3.9758599453,2,4,6
happens,22.2558272516,3.37925740755,3,5,8
adrian,22.2449221962,5.4939042246,1,2,3
geekliftus,22.2334848055,5.51993490319,1,2,3
train_town,22.2182491195,5.25970810876,1,2,3
squible,22.206855863,2.73915836797,6,7,13
moonshoe,22.2046199418,1.22644073505,30,49,79
hunter,22.1948609722,2.20634727531,7,11,18
prism,22.1846826736,5.77103200607,1,2,3
grrg,22.170430884,2.5691949268,6,11,17
toez,22.1553553726,5.17920717071,1,2,3
mickeyo64,22.1534696436,5.04649957257,1,3,4
cbones,22.1425979996,5.17784168517,1,2,3
chiefreaper,22.1151859141,5.33476205532,1,2,3
omar,22.0893075623,4.53237455108,2,4,6
giraffe,22.0832446758,5.52720444839,1,2,3
mrryanness,22.0380827897,3.72826020702,3,7,10
hotspank,22.0351424728,2.53688136129,6,12,18
hamburglar,22.0313772247,5.47262274073,1,2,3
hbrw-hammer,21.989450955,5.19683618143,1,2,3
mrpoo,21.9694395301,5.5090539933,1,2,3
mr. tit,21.9683009566,2.54189702154,5,7,12
banana fiend,21.9571408911,5.00477127102,1,2,3
zarc,21.9523180178,5.3661603852,1,2,3
han,21.8966597569,5.31977588561,1,2,3
kzidek,21.8867795024,5.53430238446,1,2,3
moustasher,21.8766091616,2.22960499709,9,16,25
papasquat,21.8765404259,1.62534136889,12,27,39
sebson,21.7693474874,4.86743439631,1,3,4
kristoff,21.7470623389,1.91129116503,12,19,31
kaddy,21.7448383797,6.97871477739,0,1,1
ocelot,21.7367683339,2.09404175154,6,19,25
pizzajokes,21.7162054905,5.50815225737,1,2,3
paco [larkin],21.7159475813,5.45508770932,1,2,3
keatsta,21.6868238423,5.27406918611,1,2,3
burnt out ninja,21.6867950646,5.49425252058,1,2,3
fawnco,21.6867950646,5.49425252058,1,2,3
cardoso,21.6780577038,5.47180539926,1,2,3
eggmcmuffin888,21.645219856,2.48397277122,5,9,14
gumbolaya!,21.6434793433,5.28700972786,1,2,3
iceking,21.632776163,2.74859549225,5,12,17
elated,21.6260896438,2.0594982392,9,16,25
dax$,21.6081512052,2.65670218281,6,6,12
halffulla,21.5895343513,3.47910309434,3,5,8
moonlight,21.5760824737,2.7022802303,4,9,13
yolochi,21.5734465791,2.39064179851,7,13,20
calzum,21.5714683394,5.33706315997,1,3,4
tubby!,21.5592309434,3.87028716387,2,6,8
slartibartfast42,21.5328392932,4.28071789839,2,4,6
macintosh,21.5300943531,3.43746131959,3,6,9
evab,21.5281310611,5.45654170068,1,2,3
ondas,21.5111827075,3.48818106101,3,5,8
zwephy,21.5047657545,5.52858492613,1,2,3
anathema,21.5047657545,5.52858492613,1,2,3
kossismoss,21.5047657545,5.52858492613,1,2,3
jirachinick,21.5047657545,5.52858492613,1,2,3
zombie!,21.5047657545,5.52858492613,1,2,3
trevman,21.5027061159,5.10402665286,1,2,3
weirdy man,21.4938394777,5.32664823819,1,2,3
sadu,21.4831253742,5.56869670732,1,2,3
fearlesscaboos,21.4726372653,5.35076046827,1,2,3
xiivi,21.4589875779,2.83517580596,5,9,14
tipc,21.4584314582,2.91058327365,4,8,12
jmabate,21.4375021927,5.28753891929,1,2,3
gray,21.4085870652,2.66174173992,5,8,13
v-bomber,21.4000216092,4.19284654502,2,4,6
whoopiecow,21.3422581477,5.51129103904,1,2,3
napkins,21.3422581477,5.51129103904,1,2,3
bubby,21.3396390978,5.35310713357,1,2,3
elrond,21.3304311736,2.44575450897,6,13,19
boink,21.3235270414,3.33612282954,4,5,9
fish,21.3036462529,7.11976757859,0,1,1
pikasneeze,21.2566875413,2.75227624374,5,6,11
frostbyte,21.2363407792,3.47852087999,3,7,10
minusev,21.228864937,7.0978953209,0,1,1
peaceful soujourner,21.1906680583,5.11420413228,1,2,3
blue bear,21.1002964099,5.55587524657,1,2,3
shasta,21.070209472,5.51002169606,1,2,3
kavon,21.070209472,5.51002169606,1,2,3
hungrybox,21.0458327936,4.48872068442,2,4,6
fingerblast,21.0282940861,4.56717238675,2,2,4
mizbiz,21.024881302,3.26864808101,4,4,8
static,21.0233871595,3.56502833648,3,5,8
kosher,20.9819870909,3.11619311577,3,6,9
catastrophe,20.9564559836,3.6992315467,3,4,7
doby,20.9444485111,4.83865375161,1,2,3
h00n,20.9365684896,3.73981919629,2,4,6
dair,20.9287602069,3.28105145945,4,4,8
zerobombjake,20.9007496649,3.22906886542,4,6,10
dr combos,20.8736212861,3.28212924962,2,8,10
tallboi,20.86995333,6.62153525107,0,1,1
java boy,20.8573962319,5.51420898734,1,2,3
fuzzyness,20.857278128,5.23816834705,1,3,4
yungpurp,20.8494147883,6.68210388938,0,1,1
apparition the ambassador,20.848989994,1.20491269672,25,55,80
seantos,20.8464191661,1.94287126302,11,23,34
big tone,20.8406120534,7.05844745916,0,1,1
lucky_hamburger,20.8276824673,2.95238933811,4,7,11
ttp,20.8082237214,3.45128227027,3,6,9
zad,20.8037023428,3.38007051069,3,7,10
eliot,20.800150921,4.9216372622,1,5,6
fork?,20.789954787,4.94820898322,1,3,4
dankey kang,20.7817105627,2.15227432732,7,17,24
jdp,20.7714579822,4.97561073223,1,2,3
buttery adachi,20.7658927504,4.64311765358,1,3,4
mojo,20.7589379883,5.1984974191,1,2,3
lalo,20.7423750734,4.13893185685,2,4,6
joel,20.6948791177,2.78112327455,5,8,13
zouzy,20.6755344261,5.54532760265,1,2,3
hipo,20.6704005576,5.21848248582,1,2,3
brotherly,20.6376153588,2.75349898716,4,7,11
benbook,20.60416798,7.17147558733,0,1,1
akajumo,20.60416798,7.17147558733,0,1,1
kayo,20.60416798,7.17147558733,0,1,1
5000candlesinthewind,20.60416798,7.17147558733,0,1,1
jad,20.60416798,7.17147558733,0,1,1
sfat,20.60416798,7.17147558733,0,1,1
sherb,20.60416798,7.17147558733,0,1,1
phalanx,20.60416798,7.17147558733,0,1,1
captain murphy,20.60416798,7.17147558733,0,1,1
yung god,20.60416798,7.17147558733,0,1,1
akito555,20.60416798,7.17147558733,0,1,1
drewjames,20.60416798,7.17147558733,0,1,1
nyani,20.60416798,7.17147558733,0,1,1
fs shampoomaster,20.60416798,7.17147558733,0,1,1
k-man,20.60416798,7.17147558733,0,1,1
penance,20.60416798,7.17147558733,0,1,1
silent skyler,20.60416798,7.17147558733,0,1,1
ragingcherry,20.60416798,7.17147558733,0,1,1
josiab,20.60416798,7.17147558733,0,1,1
bunmira,20.60416798,7.17147558733,0,1,1
lonk,20.60416798,7.17147558733,0,1,1
thissideup,20.60416798,7.17147558733,0,1,1
nannose,20.60416798,7.17147558733,0,1,1
4 phri,20.60416798,7.17147558733,0,1,1
mystery,20.60416798,7.17147558733,0,1,1
changed man,20.60416798,7.17147558733,0,1,1
uprowr,20.60416798,7.17147558733,0,1,1
nfreak,20.60416798,7.17147558733,0,1,1
queso,20.5914533132,2.82384063435,3,8,11
jaws,20.5676658066,5.35482917924,1,2,3
weedlypuff,20.5624658791,2.81705576611,4,10,14
goose,20.5405193363,3.84718671751,2,4,6
nuro,20.5389518189,5.43185785249,1,2,3
flatline,20.5164882806,5.24452888369,1,2,3
thenuge,20.5013392426,5.04003806029,1,3,4
icactusdog,20.5004895881,1.16554533757,31,76,107
heartsdealer,20.4405992168,4.22373191901,2,4,6
three beers,20.4290516618,2.69306367739,4,8,12
voff3,20.3954522573,6.99340631441,0,2,2
zach777,20.3919055678,6.32652414142,0,2,2
throwz?!,20.3712942976,5.17095113297,1,2,3
barrels,20.3686059834,3.85809326249,2,6,8
homemadewaffles,20.3612733202,6.92690169084,0,1,1
mr baninawi,20.3193599258,4.50670802383,1,2,3
cormander,20.307906168,2.70425754636,4,12,16
hero,20.3003305973,6.88831159169,0,1,1
spunker,20.2783887162,6.64193201717,0,2,2
acerunner,20.2769729281,3.82972348361,2,5,7
e-jager,20.264816834,4.96492058154,1,3,4
sk,20.2176637911,4.94316726109,1,4,5
caelan,20.204195046,7.0610632401,0,1,1
mighty afro dighty,20.175675613,3.72559001411,2,4,6
butcher of bakersfield,20.1709924669,3.98886789201,2,5,7
jag,20.1703789612,3.03001870861,4,8,12
mikeyp,20.1590540149,2.64405021878,5,10,15
mjim,20.1332832941,2.69941666379,4,12,16
papa,20.1316574799,3.04705323478,4,8,12
fritz wethermyb,20.1291632286,6.19810924156,0,2,2
teflon ron,20.1047245888,3.33080867555,2,6,8
izze,20.0992299178,4.69347685152,1,4,5
bawdbabe87,20.0547270292,2.97382419293,5,8,13
aegeze,20.0504922649,3.37838662976,3,5,8
nich,20.0388282556,3.24962465581,3,10,13
shug,20.0174526697,3.29340525545,3,8,11
accru fenix,20.0067803816,2.89673008898,3,10,13
b vu,19.9779918419,6.56462785713,0,1,1
depressed eagle,19.9668557046,4.71517261952,1,3,4
king robin,19.9562316723,5.22969831721,1,3,4
howdy,19.9547072759,2.06048100201,11,16,27
weatherman,19.9361842857,6.05438025427,0,3,3
tallyshell,19.9342139881,5.03744670312,1,2,3
takuto,19.9194568323,3.4659125885,3,4,7
kiwi,19.9136634043,3.21157120004,2,7,9
stark,19.9121368194,2.12677358391,7,15,22
maximum can,19.8807968822,6.1968182466,0,2,2
pokmo,19.877739905,2.97746563518,3,8,11
pika,19.8665160974,4.50476058035,1,4,5
frogman [charette],19.8470685379,6.53515646093,0,2,2
nineball,19.837597637,3.00615929934,3,7,10
danny,19.8132004678,6.8317061207,0,1,1
spt,19.8025232552,6.38548140082,0,2,2
dad's musical erasers,19.7703658544,6.34330364497,0,2,2
multiball,19.7552111874,2.18514133416,8,16,24
cagt,19.7525937331,1.62519474336,16,27,43
mikelangelo,19.7461948385,6.43727618769,0,2,2
sebastian,19.6262159618,2.92105598902,4,8,12
muse,19.5658720985,2.17154432387,8,14,22
rogue1wasjustok,19.5560057346,2.87935736492,3,8,11
fiasko,19.4980024216,4.80681168973,1,3,4
yaron,19.457187768,3.69052851875,1,6,7
danno,19.4480883685,5.26348120732,1,2,3
dimension,19.4061385287,6.20651346822,0,2,2
qerbstomp,19.3844727607,3.21038935416,3,10,13
diveo,19.3731783872,2.2308079542,6,18,24
tangerine,19.3601340992,2.75962484791,5,10,15
fred,19.3512733707,4.82054371145,1,4,5
fumofuu,19.3003820949,6.70094005858,0,1,1
veen,19.2649590252,6.50769593739,0,1,1
magic,19.2467102776,3.12018566886,3,5,8
houndour,19.2326998921,4.73129345731,1,5,6
missingn0,19.1950717181,6.10648839204,0,2,2
russellsprouts,19.1820196254,1.27337237155,24,69,93
rush,19.1773861775,2.88097949748,3,9,12
jive turkey,19.1618786482,4.30367932218,1,4,5
krypto,19.1590647171,4.80958059903,1,4,5
husker,19.1404494768,4.23587159018,1,5,6
bluebear,19.1400664268,2.68061884972,5,10,15
laugh,19.112999947,2.80654392874,4,10,14
bleachfanboy4life,19.0797382709,5.047761847,1,3,4
brown_omega253,19.0495734057,6.32975483504,0,2,2
k,19.0428343177,5.95249011755,0,2,2
slatts,19.017783229,1.76486828586,10,27,37
supernuggit,19.0087507894,2.47469836472,5,12,17
esmod,19.004211349,6.50799591405,0,2,2
tarn,19.0028728103,6.87267909617,0,1,1
skubtard,19.0028728103,6.87267909617,0,1,1
fs mook,19.0028728103,6.87267909617,0,1,1
jiffypop23,18.980895363,3.36073047973,3,6,9
rabizkoshik,18.9387563269,4.96521521123,1,4,5
kingcool,18.9351088349,3.64474619053,2,6,8
guccipivotmaster4000,18.9347382351,6.43705129894,0,2,2
dixoncider,18.9248200476,2.98217045439,4,9,13
ego,18.9220364506,6.43080985891,0,2,2
precookedbread,18.9052180392,6.13144583345,0,2,2
ensindic,18.8939306307,2.80274791221,4,11,15
dcmaster,18.8779986326,3.30965678361,3,6,9
engdrew,18.8749407886,2.71430595726,3,9,12
luwolf,18.8484820941,6.29597085244,0,2,2
quentendo,18.8254585517,6.15766527383,0,3,3
muthalova7,18.8091820108,3.29769105377,4,5,9
neat,18.798998525,2.45460921713,4,17,21
blizz,18.7928519856,6.79635578797,0,1,1
turtlpower,18.7895018776,6.35251859374,0,2,2
littlespoon,18.7797815395,6.3597378531,0,2,2
mr.e [rohr],18.7703709704,6.52341434227,0,2,2
bananabolts,18.7595978736,4.12859070744,1,5,6
flare,18.7464198401,4.81872483986,1,4,5
iacme,18.7005700184,5.87207445275,0,2,2
duck chris,18.6843486974,6.48895532793,0,2,2
fen,18.6651960945,4.60992013254,1,4,5
wilbur,18.6630722766,6.48089717609,0,2,2
jgin,18.6321608332,5.92034936976,0,2,2
kieuarty,18.611156125,6.46321841715,0,2,2
youtwo,18.6056078068,6.49184921396,0,2,2
r.o.m.,18.5588529466,6.38820575423,0,2,2
kl3an,18.5588529466,6.38820575423,0,2,2
pokeiman_master,18.5516219727,6.44406310517,0,2,2
crazy_cubano,18.538383148,3.26139772609,3,6,9
tdp,18.5322048421,6.27670782881,0,2,2
nathansandwich,18.5280987241,3.36738504084,3,7,10
lecceo,18.5224563478,6.04122538682,0,2,2
failcant,18.5036619979,6.53954925511,0,1,1
ltdan,18.479248394,4.30012460166,1,4,5
tbone,18.4739919389,6.26372813517,0,2,2
nagurnimaster,18.4700890997,6.22509745584,0,2,2
superkirby,18.4611593024,6.07126152759,0,2,2
ender,18.4528195454,3.08606099814,5,6,11
pugdaddyfre$hlyfeogg*flva,18.4491791431,6.2655689814,0,2,2
reno,18.4423554089,5.79143124447,0,2,2
myninja,18.4400545942,4.38110947843,1,4,5
dance!!,18.4030794924,4.26802492347,1,5,6
swerve,18.3924240113,6.39631598175,0,2,2
stdangerous,18.3869320511,6.13518467314,0,2,2
big d squirrels,18.3845697491,6.3955012082,0,2,2
cracker jones,18.3659601302,1.79371957328,9,28,37
master jay,18.3609401588,6.39052231831,0,2,2
shwang,18.3577767565,6.2521714548,0,2,2
nami,18.3449675847,6.12168390994,0,2,2
hasme,18.3361849291,5.59943655815,0,3,3
charlie harper,18.3330999134,6.38313840111,0,2,2
mntd,18.3145840949,3.37796474436,2,7,9
arcangel,18.3135059171,4.28593280058,1,5,6
oxycontin,18.3049578438,4.56472838053,1,4,5
silky johnson,18.3001715607,3.28241407531,2,8,10
blackf00t,18.2957405055,6.11791947838,0,3,3
quinceprince,18.2944270184,6.23604937648,0,2,2
vidya_james,18.2598767048,4.54149909054,1,4,5
jesusisking,18.2425746549,6.14038984196,0,2,2
tangpootie,18.2335664613,2.52640635017,5,12,17
blues,18.1874960602,4.80990360288,1,4,5
xlax,18.1874527175,4.71791538095,1,4,5
cochran,18.1192385202,4.54192921151,1,5,6
elmustachio,18.1178019254,6.11091424803,0,2,2
polarbair,18.1090064522,3.42935657682,3,6,9
jdeezel,18.096134607,6.31705839702,0,2,2
shawarma habibi,18.0853738949,3.43012970065,2,6,8
tylenol jones,18.0758497583,6.32077271178,0,2,2
avian,18.0712867461,6.31842389736,0,2,2
chi-fence,18.0503856058,4.39365185305,1,4,5
erk,18.0475218268,6.31009962984,0,2,2
warmachine1919,18.0428187692,6.46387437135,0,2,2
sweaters,18.0428187692,6.46387437135,0,2,2
√°1,18.038139844,2.58491856146,2,11,13
g-rabbit,18.0305347608,2.5412279443,5,12,17
firefly,17.9980023599,6.32119878345,0,2,2
jpoptosis,17.9980023599,6.32119878345,0,2,2
astropancakes,17.9980023599,6.32119878345,0,2,2
snack?,17.9980023599,6.32119878345,0,2,2
yam$,17.9980023599,6.32119878345,0,2,2
drhino,17.9980023599,6.32119878345,0,2,2
albinosaurus,17.9829924851,6.07981880581,0,2,2
lights,17.9722012086,6.29535962389,0,2,2
beaver,17.9564848443,6.3115571796,0,2,2
elu,17.9078592776,2.86447989398,4,12,16
armagreggon,17.8984652218,3.49239452877,2,5,7
frame,17.8843560589,2.37940546017,4,19,23
ebay,17.8407852112,6.26851580688,0,2,2
dhir,17.8270005524,6.29388615473,0,2,2
legoman,17.8270005524,6.29388615473,0,2,2
armor,17.8270005524,6.29388615473,0,2,2
akiva,17.8270005524,6.29388615473,0,2,2
jfm,17.8270005524,6.29388615473,0,2,2
mulkster,17.8270005524,6.29388615473,0,2,2
chaos pro,17.8270005524,6.29388615473,0,2,2
bc_burns,17.8270005524,6.29388615473,0,2,2
espparadox,17.8188544855,1.65873672072,11,33,44
pajhomas,17.799690587,4.277882317,1,4,5
massimo,17.7929138053,5.80630293942,0,3,3
austntatious,17.7829509186,6.06931121416,0,2,2
jello,17.7699598809,3.26225794513,2,11,13
aerodet,17.7610317598,6.37964879926,0,2,2
nadamoor,17.7571849257,6.26686880382,0,2,2
tehz,17.7291867314,3.38920903093,2,8,10
rillocks,17.7290816871,5.42359444908,0,4,4
brambramjam,17.7281304498,6.03039661814,0,2,2
frogge,17.7193296658,5.91111489472,0,2,2
jackmehoff,17.7135963077,5.86190286565,0,2,2
charlie,17.7006913652,6.02158775086,0,2,2
broonz,17.6721609535,2.08498607104,7,20,27
matt47,17.6673384456,6.26628461383,0,2,2
liam_butler,17.6673384456,6.26628461383,0,2,2
colt,17.6613529856,6.33021997137,0,2,2
ccm,17.6508121744,4.01947063687,1,6,7
 ô·¥è·¥Ö·¥Ä·¥Ñ…™·¥è·¥ús,17.6441979245,3.89311799681,1,6,7
meowmix,17.6266210627,6.3460739567,0,2,2
luka,17.6242727391,3.73622009177,2,6,8
maxi,17.6227902384,6.22931743478,0,2,2
whitegrizzly,17.6211632096,6.0044317998,0,2,2
pigwick,17.6145656845,5.7986697379,0,2,2
scootieloo,17.6025155386,5.99030365635,0,2,2
kali mist,17.6017076209,4.63097043472,1,5,6
general1712,17.5779881362,5.47693709977,0,4,4
coolguy76,17.5622485595,3.39898676833,2,6,8
bozz,17.559839839,6.18922189329,0,2,2
jollie,17.5480038107,1.68952817456,11,34,45
the drew,17.5270389625,2.43986416752,4,16,20
blank,17.5269841039,5.98245346039,0,2,2
rodan,17.5167074005,5.80608254359,0,2,2
leet,17.51006239,4.19113660022,1,6,7
gambit,17.4724485757,6.03130753421,0,2,2
maestro,17.4681984749,6.2394819151,0,2,2
chinstrap,17.4649334833,4.56998857617,1,4,5
mechanicalmarine,17.4524072942,6.30688568514,0,2,2
catlover321,17.4270201233,4.14785047453,1,4,5
scraggus,17.4207899857,6.18548881364,0,2,2
sugaaku,17.4098689344,2.50208803092,5,14,19
ponkapa,17.3984243978,4.12997066047,1,8,9
spammalanche,17.388941323,5.79163924669,0,2,2
capsui,17.3722792638,4.18536045637,1,7,8
caleb,17.3674403995,6.09652789391,0,2,2
hollow,17.3328768682,5.18743677657,0,3,3
sad,17.3097710331,6.27674314988,0,2,2
jonnjonn,17.3075690177,1.60479426509,11,37,48
harmless,17.2905728248,6.22322606387,0,2,2
mikeyg,17.2894835768,5.66175718426,0,2,2
cennis91,17.2840324135,3.59843003351,1,11,12
highlyeducational,17.2602278329,6.07035824737,0,2,2
beets,17.2574844776,5.62221721859,0,2,2
louieg,17.2302184826,5.92760188249,0,2,2
juan doe,17.2249232193,6.2595773321,0,2,2
spell,17.2165347549,3.42430593084,2,7,9
caprigon,17.1898090768,5.85996540655,0,4,4
iamlazee,17.185740056,5.94441200211,0,2,2
lv20ninja,17.1783245149,3.2295308274,3,7,10
ohhhbreezy,17.1645697169,4.37309275394,1,4,5
beech,17.1619375205,3.36034992058,1,12,13
holosly,17.1573329149,6.26923433457,0,2,2
ppdmd,17.1573329149,6.26923433457,0,2,2
kraken,17.1398541025,6.28212270869,0,1,1
superflopp,17.1396432663,2.65189633725,3,9,12
sunkin,17.1391075866,6.24032360265,0,2,2
master j.j.,17.1358355436,6.24039459921,0,2,2
jgly,17.1129023222,4.24046048034,1,4,5
starcutter,17.1011463592,6.0665411989,0,2,2
driftintheabyss,17.1009098272,6.2415552758,0,2,2
amaya,17.0988004859,6.241919664,0,2,2
dinner,17.0933637711,6.08039702859,0,3,3
professortoke,17.0687129873,6.10828884988,0,2,2
sam,17.0659865662,5.90317544352,0,2,2
pale,17.054902864,3.4311691007,2,6,8
zarfon,17.0353081779,6.09705358847,0,2,2
hotsauce,17.0337638229,2.93813932682,3,8,11
ravioli,17.0284430048,6.30597887962,0,2,2
mr_sharpie93,17.021854216,6.22090893961,0,2,2
second boss,17.0156955807,4.80079149925,1,2,3
black rob,16.9946507075,6.21682728317,0,2,2
drlight,16.9870335546,5.93536565379,0,2,2
sianvar,16.9633446681,6.49717447875,0,1,1
giggitoxin,16.9572689606,6.19807969429,0,2,2
myroknpancakes,16.9561708699,3.33326593942,2,8,10
kastakatter,16.9544806982,5.64466319093,0,4,4
rickter_scale,16.9273178368,6.23983584333,0,2,2
umi,16.9273178368,6.23983584333,0,2,2
edwin...,16.9273178368,6.23983584333,0,2,2
15(ichigo),16.9273178368,6.23983584333,0,2,2
digital cannon,16.9273178368,6.23983584333,0,2,2
sambook,16.9273178368,6.23983584333,0,2,2
irish,16.9273178368,6.23983584333,0,2,2
tuna,16.9273178368,6.23983584333,0,2,2
waffles,16.9273178368,6.23983584333,0,2,2
yuxminato,16.9273178368,6.23983584333,0,2,2
themickeynick,16.9273178368,6.23983584333,0,2,2
aubfox,16.9273178368,6.23983584333,0,2,2
searcher,16.9273178368,6.23983584333,0,2,2
dd,16.9273178368,6.23983584333,0,2,2
heisenberg,16.9273178368,6.23983584333,0,2,2
paper tiger,16.9273178368,6.23983584333,0,2,2
theycallmechris,16.9273178368,6.23983584333,0,2,2
uh what,16.9273178368,6.23983584333,0,2,2
azzy,16.9273178368,6.23983584333,0,2,2
zurdo,16.9273178368,6.23983584333,0,2,2
grraffe,16.9273178368,6.23983584333,0,2,2
jazz,16.9273178368,6.23983584333,0,2,2
d-tek,16.9273178368,6.23983584333,0,2,2
riseup93,16.9273178368,6.23983584333,0,2,2
sfgman,16.9273178368,6.23983584333,0,2,2
beekle,16.9273178368,6.23983584333,0,2,2
raxcity,16.9273178368,6.23983584333,0,2,2
gaymer,16.9273178368,6.23983584333,0,2,2
miles,16.9273178368,6.23983584333,0,2,2
muthaluva777,16.9273178368,6.23983584333,0,2,2
sunshine,16.9273178368,6.23983584333,0,2,2
zombieheart84,16.9273178368,6.23983584333,0,2,2
qk shkz,16.9273178368,6.23983584333,0,2,2
shadow light master,16.9273178368,6.23983584333,0,2,2
red,16.9273178368,6.23983584333,0,2,2
j,16.9273178368,6.23983584333,0,2,2
abc,16.9273178368,6.23983584333,0,2,2
draxsel,16.9273178368,6.23983584333,0,2,2
deku,16.9273178368,6.23983584333,0,2,2
bearrimshot,16.8963411704,5.10228214902,0,3,3
jojohnson,16.8847446083,5.91443560749,0,2,2
dexter,16.8407047957,5.72375084668,0,3,3
krutchby,16.8366823264,6.18674458762,0,2,2
shyguyking,16.8278588736,5.63034924809,0,2,2
bunnyblast,16.8164815237,6.1927063121,0,2,2
kohenbro,16.8078355606,5.51238629639,0,4,4
castaway,16.8048785331,6.06752345676,0,2,2
halqery,16.7888675082,5.27500842283,0,4,4
m2cain,16.7880607121,6.19335774512,0,2,2
babycakes,16.7840577062,3.37529954836,2,6,8
trogdorbad,16.7809512456,4.7076151072,1,2,3
mookie,16.7790762933,6.17549228699,0,2,2
sabe,16.7749433978,3.20300511544,1,7,8
comb,16.7693408964,3.52317685206,2,7,9
superduperfanofboom,16.7666227916,6.17256403512,0,2,2
robslabgod,16.7628618487,5.72732565238,0,2,2
vex kasrani,16.7506253432,3.46568325558,2,9,11
keychain,16.7220158858,3.82985769828,2,4,6
saltking,16.7042080254,5.18695098169,0,4,4
jungle,16.6711012438,4.8458711091,0,7,7
jerzilla,16.6612408912,6.01798349036,0,2,2
rockmix,16.6398271934,5.94243824195,0,2,2
rollock,16.6185563571,5.42669152397,0,3,3
silentknight,16.609691351,4.36384328756,1,6,7
sven stormbeard,16.6036406064,3.56580044814,2,6,8
scott,16.5972710002,6.15290821858,0,2,2
chibama,16.5751086678,4.23778893396,1,4,5
falker,16.5702958831,3.31026765982,3,7,10
jpeghero,16.5542790113,5.72001128222,0,3,3
madara,16.5435375987,5.28744306886,0,4,4
instacover,16.5173598147,6.03304199256,0,2,2
ejmp,16.4965744596,6.14530357824,0,1,1
dmolz,16.4944034609,4.97088534466,0,4,4
atari,16.4910932158,2.46706973871,5,15,20
lunarnova,16.4727113064,2.03200936058,6,32,38
curiousplaces,16.4686400239,5.98022918707,0,2,2
jedipanda,16.4647915137,4.78519132867,0,5,5
nnaughtydogg,16.3737904301,5.12906693269,0,4,4
bogmyer,16.3677235569,5.87555636419,0,3,3
magfmur,16.3354417012,5.811464978,0,2,2
mattatari,16.3010407307,4.3603820058,1,5,6
nuggz,16.2887511448,3.61112287626,2,10,12
recneps,16.26011104,4.30110440634,1,6,7
dr gibs,16.2021899007,5.23131951349,0,4,4
dinkleberg,16.1387773869,6.1112748168,0,2,2
thegoat,16.1110336081,6.0577218926,0,2,2
rocktimus crime,16.0992903732,4.77460142995,0,5,5
lord horatio,16.0577025758,5.55653478534,0,4,4
i use tap jump,16.0363120222,3.71930631132,1,6,7
bill,16.0346530216,3.87207608499,1,6,7
scruffy mcwonder crumpet,16.0241093748,3.29280323407,3,7,10
jedisalazar,16.0199757813,5.71550570122,0,2,2
frog,15.9970620753,4.49538272104,1,4,5
bluey,15.9664406341,5.36501108164,0,4,4
bennypuff,15.9436762365,3.5277681218,2,7,9
elitescoringguy,15.925996399,2.56542237332,3,14,17
duma,15.9120359434,3.61593040392,1,8,9
mrkymrk,15.8980366699,4.78982221621,0,5,5
redwolf,15.8831330222,5.97846405882,0,2,2
noelkitten,15.8731505615,5.65452520089,0,2,2
eclipse,15.8697672796,5.17892867504,0,4,4
yolft,15.8404992071,2.41450237713,2,21,23
12ties,15.8316589618,3.47780750909,1,5,6
thedarkdreamer,15.802391653,6.01484204148,0,2,2
codytappen,15.7853216507,5.6088576584,0,2,2
lampyshade,15.78467656,5.40882274793,0,4,4
jackkenney,15.7585225492,5.64899828726,0,2,2
blahguy,15.7454563257,5.81008494948,0,2,2
lloyd-black,15.7316993222,3.58247607771,1,8,9
turquoise,15.7298542645,3.2644136497,2,7,9
vondo,15.7240700032,4.72021122034,0,5,5
2%gay,15.7133533534,4.0707821259,1,8,9
spaz,15.7089934657,4.1919065969,1,4,5
don,15.7075980388,3.55903525596,2,5,7
twunt,15.7029781189,2.91269801832,2,13,15
norwayray,15.6848991191,5.25386270482,0,2,2
dk dredd,15.6475640437,5.91830761396,0,2,2
mm720,15.6457623377,5.58325071289,0,4,4
kobra,15.5969913254,3.16500028166,2,11,13
uncle onion,15.5522960143,5.93876560258,0,2,2
katiebug (sfk),15.5257668944,5.60340187496,0,2,2
tydye,15.4962095478,5.71435404844,0,2,2
bennyboy98,15.4862446417,5.96174045904,0,2,2
swankeaboo,15.467720008,4.83969727764,0,6,6
shimshamlando,15.4405329919,2.30812443759,4,28,32
fmaj7,15.3829135413,3.88143441716,1,6,7
lou sanus,15.3809767544,4.5666113781,0,6,6
t-bone,15.3746043129,3.41400726639,2,6,8
mzadeh,15.3370943213,5.22460830461,0,4,4
peacemaker,15.2694601263,4.37786299112,0,6,6
tanuki,15.2414745664,5.77050178339,0,2,2
lvl99wizard,15.2303630974,4.90275652045,0,4,4
tron,15.2082819708,5.60706639355,0,4,4
mariokartmoney,15.2023991933,5.46979181665,0,4,4
vnko,15.1947707911,4.1461730085,1,4,5
ir,15.1926349288,3.90186447947,1,6,7
godspeed,15.1675586068,4.06536906148,1,7,8
kezzup,15.1412021645,3.62889215445,1,8,9
bagel,15.1356957542,5.1963265951,0,4,4
dude wut,15.1319870257,4.51032162173,1,4,5
wiseacre,15.1197026122,3.57275273355,1,11,12
thisisgettingold,15.115537955,5.93072884891,0,2,2
bung0o,15.0861921012,5.20344175089,0,4,4
warhorse,15.0483929435,3.76780847328,1,6,7
zbomber,15.0455870546,4.94095154001,0,4,4
rumi1819,15.032897614,5.25196275362,0,4,4
fry,15.0135650256,2.92646927724,2,13,15
dyo,14.9971186984,3.54213130021,2,6,8
dr-wumbo,14.9839655426,5.50492602216,0,2,2
ceephax,14.8595237801,5.78946898394,0,2,2
hufff,14.8471841973,3.6304224798,1,6,7
captainpugh,14.8466293662,5.52907629468,0,4,4
fig,14.8379883515,5.44294090835,0,4,4
adulix,14.7935449934,4.99541774313,0,5,5
bchill,14.701933648,3.21107553572,2,7,9
meccs,14.6994748045,5.02019102092,0,5,5
snoosnoo,14.6669262862,4.23919883005,1,4,5
cnasty613,14.6162591061,3.46401947596,2,6,8
feartheday,14.6134099181,2.88325101411,1,18,19
kevorkian,14.5903663267,2.82565813666,3,13,16
showtime,14.5887361904,5.82355811529,0,2,2
bear,14.5885031086,5.31724245585,0,4,4
drunkn smash,14.5537577826,4.50699209061,0,5,5
goofinhiemer,14.5139115598,4.98917843814,0,4,4
midgetto,14.5083152078,2.31133177431,4,18,22
dennysgrandslambreakfast,14.4903716763,5.16776244222,0,4,4
fmax,14.4895155373,5.50407742618,0,4,4
marfthekid,14.4771988397,5.52665305419,0,4,4
yaks,14.4268607087,3.69172500367,1,8,9
hiddenmi$t,14.3567932137,4.93852809358,0,4,4
ngwn,14.3416677002,3.40106693915,1,9,10
cag,14.3368913197,5.13462413617,0,4,4
armadillo,14.3348203516,4.55671505604,0,6,6
ryden hope,14.2910190469,5.6998136168,0,2,2
auggie,14.2413630986,4.08068507041,0,9,9
sevshun,14.2373187885,3.41262717189,1,9,10
rhubarb,14.2343626496,2.40289008028,3,18,21
usvn,14.2304467443,3.37350940241,1,11,12
spaghetti,14.2199269774,3.01966503768,1,11,12
cgmontage,14.1793613186,4.15801439516,0,7,7
fj20,14.1146328983,3.17526215271,2,7,9
primefry,14.0908698742,3.066916257,1,11,12
chacalaca88,14.0649425463,4.51919750276,0,6,6
hiv+,13.8947085511,3.40155918202,1,8,9
myk,13.8626267077,5.36647171848,0,4,4
edgar allen pwn,13.8505266913,3.61735400361,1,10,11
oquinn,13.8471710861,4.4015557248,1,4,5
chibaco,13.8470270023,4.24063087175,0,8,8
telemonic,13.8433720523,5.11135169352,0,4,4
road-rage 64,13.7972111929,4.50237227325,0,6,6
turtle,13.7802011181,4.40063805448,0,8,8
bort,13.7208604975,4.06188112395,0,6,6
mf space,13.7014586201,4.73229905966,0,5,5
rich,13.7007160926,4.94211244526,0,5,5
frapple_apple,13.6823484302,3.50691179819,1,7,8
kronk!,13.677071559,2.63580223992,2,18,20
scruff,13.6055926044,4.97174752767,0,6,6
mattc,13.5997265059,4.33239235453,0,5,5
lotionhole,13.5886777174,4.4191355995,0,6,6
mike4real,13.5883698447,3.33667113431,2,10,12
bluntsmokinganusdestroyer,13.5611502967,5.3496724429,0,4,4
cat,13.5100554597,4.71980783012,0,5,5
hashi,13.5014461223,2.43780085267,3,22,25
whiz kid,13.4212074591,5.16852123362,0,4,4
blanco mano,13.4015177081,4.59893174621,0,5,5
heavy,13.3676437111,4.15906526084,0,5,5
scaryman,13.3668329574,4.32703399476,0,6,6
ben,13.3661823696,2.55009030633,2,16,18
woof,13.2208606529,5.01298816141,0,5,5
gato,13.2003100123,4.41907845794,0,5,5
dabs?,13.1841331753,4.09674797223,0,9,9
hwatts,13.1813723801,3.67499081126,0,13,13
mop,13.1737850185,3.28003065969,1,8,9
neff,13.0966871337,5.55830696098,0,3,3
godofgrunts,13.0523014006,4.76380986355,0,7,7
oldiz,13.0151259126,5.12129932797,0,4,4
greatwhitebuffalo,13.0134298307,4.66184832423,0,3,3
sour,13.0130302613,3.75381522794,0,10,10
brother quang,12.9059125282,3.33531348028,2,8,10
weslec,12.8998200195,3.74920001119,0,8,8
lotus,12.8993820586,5.4772393945,0,2,2
zorro253,12.8863600716,3.25248432631,1,10,11
monica,12.8133167623,4.5803659133,0,5,5
boogie!,12.7724028169,3.01457467761,1,14,15
ferguz,12.7417758477,4.88198605191,0,6,6
nardwell,12.7091102793,1.87944226936,6,45,51
twisty,12.680208489,2.58144015468,2,27,29
shunkun,12.6443348132,4.59529662199,0,6,6
rokd,12.6303950189,4.61591274061,0,4,4
jimbot,12.5261010076,4.50079562529,0,7,7
phynque,12.4643306153,3.45429209749,0,12,12
atlas,12.4397770332,2.96925510691,1,13,14
gasmask,12.4369115868,3.91592253354,0,8,8
tyler_stewart8,12.3160212146,3.60324220889,1,6,7
fabulousboy,12.3102554965,3.83493299863,0,9,9
terrible fate,12.2806233227,3.52122049676,1,12,13
putpasswordhere,12.2563304752,4.50596134412,0,8,8
neph_girl,12.104315017,2.95183274354,1,14,15
ohb-noa,12.0976067652,4.13535848723,0,8,8
lolitaz667,12.0487399875,3.33068582899,1,8,9
doublej,12.0485572008,3.55735669522,0,13,13
b rod,11.8022457107,5.01592056794,0,5,5
jame,11.7132152848,3.36737732265,1,10,11
syph,11.6981609757,3.62880127994,0,9,9
little things,11.6560085431,4.0102252743,0,7,7
nicklebackair,11.62049456,3.50536528823,0,9,9
whitezebra,11.5327643057,3.57944141068,0,10,10
mambo,11.4462046767,4.89573849495,0,4,4
half man,11.4022334242,3.67158541294,0,8,8
microwaved hotdogs,11.3780445741,4.10027434638,0,10,10
baloo,11.3379080625,4.48830868231,0,5,5
t3rquoise,11.3370483679,3.83441666272,0,10,10
stormcrow2,11.2895657194,3.47076052669,0,9,9
ranger,11.23653116,4.06907183609,0,10,10
reject,11.0849067824,2.51348478084,1,27,28
mello,11.0221053839,3.16711524378,1,16,17
qwesseccssffdy,10.910530839,4.93788322606,0,4,4
stevenballoons,10.885199305,3.14324671539,1,9,10
jerry bean,10.7616734167,5.18131819279,0,2,2
2p,10.5310094708,3.31706114691,0,16,16
knothy,10.5234903977,3.62664005859,0,12,12
ceec,10.4839575004,3.43639564353,1,10,11
brizzles,10.391568142,4.01692431387,0,8,8
lloyd.,10.172377135,3.64491029164,0,9,9
