player,mu,sigma,wins,losses,sets
hwats,9.91560452591,3.55311351866,0,12,12
yung duccboii,9.86715537325,3.96131664653,0,7,7
sucksatgames,9.86410932773,3.88176539703,0,6,6
fog man,9.77858545829,3.43878545209,0,9,9
seaniemaster,9.63925968653,3.79718537136,0,8,8
oquinn,9.56202002316,3.16157852624,1,11,12
macrado,9.51529402923,3.40572182143,0,13,13
gluu,9.41779991835,3.88605818159,0,6,6
big sippy,9.34410233046,3.56857381011,0,10,10
soggy biscuit,9.2359630317,3.41422556647,0,9,9
zoom,9.0189659588,3.51823832795,0,9,9
seaweed dragon,9.00421498564,3.70206537361,0,8,8
golfclubninja,8.73920485206,2.8239237377,1,28,29
shunkun,8.4328950614,3.30383480871,0,16,16
archduke,7.47979804594,3.60778476718,0,9,9
superboomfan,51.152216873,1.18110765832,194,11,205
alvin,48.9514351704,1.20538938338,87,11,98
fukurou,48.9442435384,1.6091560836,42,4,46
kysk,46.192508579,2.03455958719,18,4,22
mariguas,46.0670255977,1.10593724504,104,22,126
kurabba,46.0015092219,1.93768340042,20,4,24
wario,45.9998031863,2.29011495417,18,3,21
wizzrobe,45.9894086768,1.08597380983,104,23,127
gerson,45.3675190677,3.02736234474,10,0,10
wangera,45.3419021593,1.70199757884,29,7,36
kerokeroppi,45.1730303943,1.13731801863,75,21,96
dext3r,45.1022851944,1.20067807948,69,18,87
isai,44.6635092675,1.31787426075,61,13,74
zero,44.0211972201,1.10954610988,92,22,114
tacos,43.623740147,1.23757892929,69,19,88
prince,43.4290417408,2.16072807492,17,4,21
fox,43.3225082379,1.29801250548,56,12,68
revan,42.9766477385,1.08293890303,79,25,104
joshi,42.8011083508,1.84349932328,21,5,26
sultan,42.4771305981,3.03848180018,10,1,11
josh brody,42.1946153515,0.924553296022,197,63,260
lowww,42.1907363008,1.35230973596,53,11,64
yu-kun,41.8348640554,3.06735263677,5,2,7
gyaki,41.7552972612,2.71531130374,11,2,13
cali64nia,41.55749491,2.81595784442,10,2,12
tr3gthez,41.5223932835,1.12803959526,67,24,91
hiyo,41.4588433904,2.7788945615,9,2,11
taimai,40.9493280982,3.05062930104,5,2,7
stranded,40.7304343713,1.21670528533,63,19,82
tavomono,40.6060378811,2.56394714379,9,3,12
lord narwhal,40.0333043472,1.1827941885,60,20,80
robert,39.9457152396,1.31278978905,44,15,59
hero pie,39.9261976317,1.66119631688,31,9,40
jaimehr,39.8184655239,1.25455607101,49,21,70
dtan,39.638551742,1.61403570582,24,10,34
firo,39.6380815176,1.46270997989,35,14,49
kort,39.4866275857,1.28192658301,39,18,57
cobr,39.4441024,1.18848364722,58,21,79
derek,39.4097379787,1.70009589788,16,10,26
hammerheart,39.0506946755,1.25732951805,55,18,73
ctg,38.9314799436,0.972076449057,104,39,143
shalaka,38.7958866571,1.66199470732,27,11,38
banze,38.5293407307,2.45452124809,11,5,16
sheermadness,38.5155366183,2.05571692325,16,6,22
czar,38.5113621732,1.68349460467,28,9,37
ybombb,38.5097118168,1.40383291625,34,15,49
kd3,38.3451182337,1.05721626866,83,27,110
heropie,38.0553134951,2.25194036049,12,5,17
fireblaster,37.9578654807,0.906513444976,146,60,206
star king,37.8847909026,1.25464488875,50,20,70
handsometom,37.645432447,2.03243061892,14,8,22
fancey,37.6273777708,2.92655060324,8,3,11
nacl,37.5955034271,1.15313258867,52,25,77
clubbadubba,37.5878570836,1.56989194727,30,12,42
combo blaze,37.5222228149,1.45874925551,37,16,53
manjaro,37.502231284,3.14444426303,8,3,11
cesar,37.4880347923,2.86170906031,7,3,10
kimimaru,37.2796267872,1.72728862723,23,12,35
bonobono,37.2164654907,3.30936650932,5,2,7
nta,36.7403563893,1.73297342619,23,10,33
janitor,36.7171819774,1.36995074438,45,19,64
yellowbob0,36.5650363651,3.08786334791,9,2,11
kyle tree,36.4396846943,1.92117372865,18,10,28
marbles,36.1962087746,1.15970229284,56,24,80
loto,36.1929248286,1.2404019087,42,21,63
greginator,36.1417023947,3.46750219884,4,2,6
skg,36.0598231103,1.27614321701,36,18,54
shears,36.0340588188,0.902338706846,144,70,214
finio,35.9819079944,1.24335453851,44,21,65
stevie g,35.9574672368,1.36089030229,40,14,54
yunque,35.7786220795,1.46784213991,31,15,46
nintendude,35.7769457024,1.19584189281,53,29,82
jason,35.7553030363,1.28855199392,37,18,55
eg,35.6893396477,1.18572147054,45,22,67
janco,35.6862762922,1.28758238659,31,24,55
roman,35.53888459,1.51357559156,34,16,50
horbie,35.446387902,1.1659684564,61,29,90
hydra,35.4196293296,1.73005490903,23,11,34
darkhorse,35.280543429,0.924750632448,103,59,162
lorenzo,35.167530808,1.64997530768,24,11,35
antwon420,35.103321937,1.98315696786,15,7,22
connor,35.0361506517,2.19116847736,16,7,23
sotoh,34.9363472863,1.40642672594,34,19,53
fumbles,34.9123432137,2.14771879322,14,6,20
nothing,34.8894875182,2.23781861327,14,6,20
blondekid,34.8216896271,1.73700690306,22,11,33
mohinder,34.8193318781,2.28754695691,10,6,16
purple circle,34.7870512741,2.83769233268,12,4,16
bloodpeach,34.7481117828,1.82588224498,20,9,29
amida,34.66466546,2.26845659057,12,7,19
jose,34.6553173296,2.58731416612,8,4,12
$$$ jim $$$,34.6543825305,1.44488841661,32,16,48
hotline,34.5372447409,1.66165427123,21,11,32
letsgo,34.4954470917,1.81095737,19,12,31
vinsanity,34.4472932336,1.87127835906,16,8,24
daniel,34.3969111688,1.62937077066,21,14,35
jam,34.3464661928,2.59567031537,8,5,13
gilkaoz,34.2899164689,3.27558941273,6,4,10
dark gentleman,34.2773874101,1.1668040457,50,26,76
wez,34.2100625362,3.55649626669,5,3,8
supa,34.068994351,1.60666101392,22,13,35
freean,34.0082798836,1.29630292655,43,21,64
gravyfingers,33.9888689797,2.05410413415,17,8,25
yobo,33.9682883346,1.1256024821,54,32,86
timemachine,33.9656934579,1.38825645903,34,18,52
the ki of chaos,33.9035951624,5.89649311805,1,0,1
schickler,33.9016732443,2.64686699492,9,4,13
madrush,33.8689871526,0.966311775255,79,56,135
cover,33.7453629896,3.24274481784,5,4,9
preston,33.7068162736,1.08442122325,56,36,92
james3927,33.5731171934,2.5314337127,11,4,15
wookiee,33.5496842984,1.33886936519,38,21,59
masterhandjob,33.4772661075,1.11242875562,54,30,84
butt solo,33.4605600443,3.79316952307,3,3,6
time machine,33.4364421156,1.84330727707,19,10,29
b link,33.4210302855,3.4233122782,4,3,7
pugs,33.2789543436,1.26126175141,35,24,59
fruity,33.2496472548,3.52678333572,5,2,7
fishaman p,33.2315374621,2.39958317255,9,6,15
raychu,33.2100915044,1.24347828742,47,22,69
satan [turner],33.1302282763,3.30465944315,4,3,7
facechew,33.1235160338,3.94508944253,5,2,7
hipstur,33.0920112607,1.27377677334,44,23,67
sedda,33.0055764153,1.35981708249,36,20,56
sextc,32.9516557065,1.55434008258,23,18,41
zeppelin,32.9315705413,3.10089909277,5,3,8
snorlax,32.9109445391,1.5020947849,25,16,41
shihman,32.8952229427,1.25834463632,42,26,68
smash jesus,32.886729361,2.28526436734,14,6,20
bo,32.8779119223,2.00416448544,14,9,23
monte,32.8662754864,1.92254046501,15,6,21
sax,32.8197776036,2.20498365827,12,7,19
indefa,32.8179615521,1.92391750697,19,9,28
mojomonkey,32.7849551981,2.19554294352,12,7,19
the protagonist,32.7405445798,1.16131486461,50,32,82
sunnyb,32.7262291834,3.53978882291,4,3,7
dr. grin,32.6984938352,1.89144135066,17,12,29
fray,32.668049639,2.05889737996,6,9,15
dogs_johnson,32.6434856494,1.19158266365,48,28,76
dajjal,32.6280387289,1.91642269883,16,10,26
cyoonit,32.5688418942,1.86761894266,14,10,24
mr.sir,32.5388597651,1.11168567065,55,35,90
j.moosh,32.489072318,2.8043049024,9,4,13
poobearninja,32.3955164492,2.84251448892,9,4,13
dishier wand,32.3930357568,1.38873188792,31,23,54
tictactactic,32.346702612,3.83424124403,5,2,7
jay_mute$,32.2902279995,1.67439848895,20,12,32
bard,32.265113917,1.22839183878,38,28,66
paco,32.2590072704,1.31895074228,37,23,60
th3kuzinator,32.2510522274,3.32973721641,6,4,10
gildo,32.2199274109,1.55424579543,27,14,41
eggmode,32.2179324078,2.44396247435,10,8,18
andykins,32.1898856486,1.41838312426,29,16,45
subtle,32.1109233104,2.33090125091,13,9,22
the dark gentleman,32.0598174595,3.5530006426,4,3,7
near,32.052240392,1.91997733485,16,9,25
ken,32.0364135597,5.47072518846,2,1,3
jay-r,32.017703369,1.52689829969,26,15,41
b0n,31.9822767556,3.9641478883,4,2,6
nickelbackstreetboy,31.9236165791,3.60137323461,4,2,6
hippo,31.8418294125,3.58040394194,4,4,8
knitephox,31.8241682027,2.42115737456,10,7,17
dubs,31.8199800643,3.93041150467,4,2,6
weedwack,31.8085508051,1.58537285284,21,17,38
stonefallow,31.7695041454,3.93595631344,4,2,6
dogg,31.7687157334,2.62721106565,8,6,14
spongy,31.7368589515,1.25442592232,39,22,61
spark,31.6879752723,2.77373735157,7,4,11
elel,31.6465979076,1.55271118856,28,18,46
tank,31.6309759061,2.48854963595,10,7,17
battlecow,31.6123741606,3.40058678089,4,3,7
qapples,31.5667785501,1.33037441476,32,26,58
socrates,31.5635252214,2.50975863116,7,6,13
nyx,31.5578727518,2.13817283877,15,7,22
moosh_da_moosh,31.4544285643,2.09158215333,14,8,22
q!,31.3219312744,1.28070075702,38,28,66
commander,31.219157037,4.42278572814,3,2,5
dr. lampy,31.1965120166,1.62028362334,18,12,30
deathcpo,31.1869820829,1.24617066641,37,28,65
saltsizzle,31.1719953595,1.74263367604,17,13,30
rossi,31.1312028168,4.20548682927,3,2,5
pete,31.0990824104,3.62685915722,4,3,7
josephzander,31.0857286172,3.42141203841,5,3,8
komotonoto,31.0642601175,2.27380709079,11,7,18
d35,31.0581133613,1.65230452816,20,15,35
a to the z,31.0222631746,2.10096988894,11,10,21
tyhiggz,30.9715606231,1.18403396542,43,30,73
studstill,30.9356876947,3.07598604096,7,4,11
kaz,30.9280143071,1.15400559178,51,31,82
ivor,30.8866197892,4.09947611008,3,2,5
jimmy joe,30.8735535778,1.1015744432,43,42,85
shanks,30.8332204236,2.93890298675,6,5,11
borlin morlan,30.7892617194,4.17308790286,4,2,6
gunnermaniac,30.7708229295,1.97892178519,12,10,22
a$,30.7323849882,2.35419506012,10,6,16
miniohh!,30.6868859557,1.64624967205,20,13,33
onski,30.6583846277,1.33288230494,33,26,59
se√±orhen10r,30.6307207275,3.47857587246,4,3,7
rusty,30.6194549337,1.22850332036,34,28,62
fck vwls,30.5847728526,1.54680449849,20,21,41
therm,30.5188048089,3.99876393877,4,2,6
zeozen,30.4987125107,3.97233829561,4,3,7
jamjar,30.4630715022,1.08602631639,53,43,96
limesoda,30.4623514162,1.66066019508,21,15,36
joker,30.4545328977,4.04659609764,2,3,5
bowl,30.4270675475,1.63737883056,19,17,36
bon,30.41609397,2.52181202133,8,9,17
g0d,30.3697902473,4.37109620814,2,2,4
natty,30.3609042594,2.78635134452,7,4,11
skyfire,30.331507558,1.82687602851,14,12,26
bread,30.3208009053,1.74301098687,17,15,32
yoleo,30.3174006615,1.59704922511,20,17,37
captain l,30.3120940539,1.90258483412,14,15,29
repsguy,30.3046227951,5.09748592088,1,1,2
scoback,30.2769216792,2.45519213745,9,9,18
american patriot,30.275799722,2.3494413611,8,5,13
fancy,30.2534963254,4.26968845678,3,2,5
the big d,30.2154759168,1.7882220788,12,15,27
saintheavens,30.1897749539,3.5091079514,4,4,8
the (.)(.),30.1885942126,2.40210779013,9,7,16
llcstoism,30.1868100721,1.74279746379,17,15,32
korobeniki,30.1233147358,1.2767949771,38,28,66
emptyw,30.0908663686,2.67632936017,8,5,13
captain fabulous,30.0713550924,1.45451986677,27,21,48
lob,30.0383846911,1.89799142312,16,10,26
rith,30.0135657531,3.90958200199,3,3,6
wincancel,29.9959225225,1.90955052168,19,10,29
üö®üö®üö® wee woo wee woo wee woo üö®üö®üö® you are being detained üëÆüèªüëÆüèªüëÆüèª for being awake during real falco hours üïêüëåüèªüòè please show me your real falco registration üôèüèªüìù by smashing the mothafuccin b button,29.9609131121,4.19505800663,4,2,6
pizza jokes,29.9477779019,3.52711069323,3,3,6
mokkori,29.9221620874,4.18659466566,3,2,5
daniels,29.8559361089,1.55460441603,24,17,41
moogle,29.8328805413,4.33168728203,3,2,5
bt,29.8125067321,2.16877679207,9,8,17
heny935,29.7482447384,3.94774568711,4,2,6
b33f,29.6756824159,1.36437336495,30,21,51
v,29.6606266361,1.36924786823,29,25,54
olbus,29.605970952,3.91442877446,4,2,6
mr. wang,29.6048887164,4.10245695982,4,2,6
crockett,29.6028357711,2.44088689091,8,6,14
pewpewu,29.5985878938,3.06822292588,8,5,13
spamus,29.5937410321,1.30523641193,30,28,58
razz,29.5903021321,1.04290257349,61,46,107
bert,29.5715453945,4.00879564606,4,3,7
reptar,29.5292166426,1.29854593924,34,27,61
zuber,29.5234406389,3.48916088475,3,5,8
the american patriot,29.4373245494,4.21048447834,4,2,6
umbra,29.4207807796,3.27394811363,6,4,10
sheick,29.4187792902,3.12144220053,6,5,11
piratetrips,29.4046605195,2.82222288644,7,4,11
sampai,29.39583202,7.17147558733,1,0,1
blue,29.39583202,7.17147558733,1,0,1
stingers,29.39583202,7.17147558733,1,0,1
sarge,29.39583202,7.17147558733,1,0,1
dublat,29.39583202,7.17147558733,1,0,1
charky,29.39583202,7.17147558733,1,0,1
newbtube,29.3874166692,2.73444102787,5,5,10
rocket,29.382416227,1.33769191798,28,25,53
greeno,29.3555576464,1.65758839714,23,15,38
jxc,29.354615162,2.12009084529,11,8,19
annex,29.3532797526,1.81107429782,18,14,32
reefybeefy,29.2704989952,1.8298772745,14,13,27
quitrage,29.2690864086,3.26442454461,5,4,9
logic,29.2439864819,2.12358354971,10,8,18
0prah,29.228664388,2.84358983707,6,6,12
morino,29.2260895886,3.85461294267,3,3,6
natendo,29.2233127103,2.05951368466,12,8,20
t-beau,29.2022215085,2.78791484007,7,6,13
thord's bro,29.2018388015,3.15477439553,5,4,9
chet dunskies,29.1915040154,3.46447807801,5,3,8
dizzle,29.1770066909,1.37401313964,26,27,53
taiko,29.1193309692,2.98758315882,5,6,11
aerosheep,29.0586191607,3.96947931836,4,3,7
toro,29.0095603006,4.38928209674,3,2,5
white,29.0066041639,2.14382703672,15,9,24
kriskringle,28.9934369576,2.22199693825,10,7,17
fil,28.9441972302,1.37131119989,26,28,54
nesskhalifa,28.888066679,1.59902054614,20,19,39
tot,28.8709345212,4.14715613157,3,3,6
touque,28.8694797038,4.25834877265,3,2,5
king lumsy,28.8677878745,2.65396285206,7,6,13
backes,28.8242837569,4.50100688633,2,3,5
yrn,28.8230310108,2.25936113149,8,8,16
allgreen,28.8069923235,2.44420361586,7,6,13
elvis,28.7587498633,4.26553689379,3,2,5
gt,28.7158909726,0.922555477451,92,84,176
duffman,28.7155700074,4.39090384116,3,2,5
bamster,28.6016812845,3.4555693944,5,4,9
cody,28.5961834302,4.7221053555,3,2,5
a la carte,28.5782965282,3.5456319422,5,4,9
fenlet,28.564880668,4.73761829285,2,2,4
kelvinheit,28.5516090856,1.43607539939,29,19,48
birdlordmasterbeak,28.5429251864,7.1211258753,1,0,1
broly,28.5354272176,2.33846276971,11,7,18
smurf,28.5164493153,1.1781956896,45,40,85
mustard tiger,28.4814674921,3.27858471177,6,4,10
zuko,28.4715590458,1.9401822724,16,14,30
breakthrough,28.4703886026,1.9451382266,13,14,27
pathall,28.4599061804,4.63705304508,2,2,4
cam,28.4536201639,1.97988411993,10,12,22
tonester,28.3873930729,2.04767691051,14,10,24
phut,28.3223415456,3.99197197983,3,3,6
tvdonk,28.3203937299,4.45958674045,3,2,5
ibc,28.3095455652,3.36248846749,4,4,8
slappypoopy,28.306366059,1.5927330879,22,18,40
coin chaser,28.2990279648,4.40912520839,3,2,5
purtle,28.2570943938,1.9603046061,12,12,24
fenrir,28.2177453311,4.67051655447,2,2,4
blaise,28.2055181803,4.52219949795,3,2,5
peasantloaf,28.1958652619,4.26248928484,3,2,5
bloogo,28.1766764053,1.14770899909,39,37,76
jsmirk,28.1547397586,1.510841458,26,22,48
autobaun,28.1529055021,4.53845634446,3,2,5
nattyb,28.1340321176,4.41412338,3,2,5
darkneon,28.1114688199,2.55493658731,9,6,15
toronto joe,28.0996945701,4.53051547838,3,2,5
bacorn,28.0790365185,2.46074902297,9,9,18
velocity jones,28.065617509,1.12161045392,47,44,91
batterybird,28.0646892936,4.53376969681,3,2,5
epic!,28.0331684512,2.99033112256,6,4,10
kraines,28.0154055579,4.8746850721,3,1,4
professor_wizard,27.9977133117,1.44394009117,29,22,51
sebula4,27.9711233548,4.45140829467,3,2,5
ringedge,27.9573103407,1.39590138974,25,22,47
box765,27.8471726881,1.38389719985,21,25,46
anotherish,27.8382146882,4.74296506819,3,2,5
mr. slimey,27.8363270892,4.72813856736,2,2,4
enneielle,27.8195884603,3.84402021199,3,3,6
fake,27.8058066853,3.24478944451,4,4,8
dragoniota,27.7660977373,4.48734501111,3,2,5
automatic,27.7620312144,1.6544921887,16,19,35
xor,27.7306959177,4.55622523955,3,2,5
waxy:joe,27.7269507798,1.33812025688,24,25,49
maliki,27.6887426205,2.08220388307,13,11,24
xyk,27.6764184763,4.4512066855,4,2,6
rishi,27.6430081815,5.6451943891,2,2,4
hack,27.6218521324,1.66670379131,19,17,36
rizner,27.6047275436,1.76722851621,18,16,34
zyrg,27.5575122872,3.14803363505,5,4,9
marlwolfe,27.552619447,3.82671112369,3,3,6
t0mmii,27.5268971516,4.50511998972,3,2,5
maniac379,27.4678272347,1.31709838561,31,33,64
quickcav,27.4547248644,3.25624383227,5,3,8
bigfish,27.4291265377,1.94125126104,15,11,26
kelpsicle,27.4042862287,4.26894308345,3,3,6
duff man,27.3819721399,1.95231958416,12,14,26
darv,27.3269730524,2.29687690366,9,10,19
maze,27.3051482999,4.92096032453,2,2,4
toa,27.2981991653,5.42645479228,2,2,4
dpb,27.2936032517,4.60076381324,3,2,5
my buddy mike,27.2872788777,5.14536236891,2,2,4
ern,27.2752491302,4.52152801546,3,2,5
viberant,27.243675067,2.51552953052,8,7,15
1000,27.2336915033,5.26256748611,2,2,4
beans,27.2271095393,1.70929581376,18,15,33
m-angry,27.1250611018,2.13058466503,11,9,20
r6=s2=(sr)2=1>,27.1051255295,3.78108081667,3,2,5
meromorph,27.087919362,5.02353946238,2,2,4
dam_tewton,27.0814444505,2.31908493795,9,10,19
vanillarin,27.0570896205,3.10336422529,6,6,12
okuser,26.9989787496,2.20508804621,8,10,18
starchild,26.9823917849,4.69991080447,2,2,4
pizza,26.9781527673,1.52379577499,23,25,48
vudujin,26.9460054325,4.79897904172,2,2,4
flanders,26.9325276194,2.86140652578,7,5,12
kyle,26.9191015332,1.93561293513,13,11,24
jnatty,26.8782474451,3.09281143493,6,6,12
the yid,26.8235217559,1.14794714427,42,45,87
sunflower,26.8186331912,1.37816970408,25,28,53
vanddar,26.812335727,4.90847115312,2,2,4
el man,26.7605163912,2.59531724317,7,5,12
kaladin,26.7588062893,4.84757461904,2,2,4
cam2,26.7311207345,2.35274759376,7,8,15
blue lantern,26.7244838274,4.92273128467,2,2,4
salami,26.708833892,3.08798968895,6,5,11
shake,26.6988526258,2.53857870039,7,9,16
big dick damage,26.6835829261,3.23305357606,4,4,8
abszero,26.6766861614,4.21915893279,3,3,6
maps,26.6692395496,1.50479915408,20,21,41
walkrofsky,26.6381977051,1.76042473913,12,17,29
shyboy,26.6343030405,4.82060840724,2,2,4
ham,26.6257895774,1.56169250583,20,22,42
inukem,26.5917234015,2.8206645982,4,6,10
cwic-beam,26.5687185954,1.92032278004,14,14,28
sav,26.5630567845,2.34455390591,8,7,15
synth,26.5412903818,4.63633055203,2,2,4
mortech,26.5371657625,1.80888355718,15,14,29
hoofy,26.5280944452,1.59537758583,22,20,42
fudgeball,26.5061537997,4.15305452586,2,2,4
dad,26.5053869908,2.90193209918,7,5,12
mr.watchandlearn,26.4657431583,4.9491304849,2,2,4
oh thomas,26.4598382664,4.30857636116,3,3,6
k rool,26.4360917073,1.42712700609,26,26,52
beavith,26.4344800719,2.82602967113,6,4,10
clumsy,26.4231521057,5.24172278006,2,2,4
killahertz,26.3945367452,3.04099136804,5,6,11
hypa,26.3913426521,4.85842644573,2,2,4
mando,26.3866331117,2.17280896418,10,13,23
whitejesus,26.3773585244,1.23197867041,30,36,66
gooby,26.3234325627,2.78516259718,6,7,13
stonehaus,26.3144683052,4.85649340991,3,2,5
cam1,26.2689518145,2.53088264397,8,7,15
thomdore,26.2586811481,5.07049707106,2,2,4
kirbyrocket,26.2455421791,4.28989771343,3,2,5
hhhhhhhhhhhhhhh,26.1805605948,4.94442759964,2,2,4
king funk,26.1269694471,4.12329921626,2,3,5
stew,26.0911535869,1.30391040326,32,34,66
shishkabobs5,26.0718708003,5.37780397789,2,2,4
flatvi,26.0415599717,4.23396464636,3,3,6
droc,26.0257275555,1.36789989708,24,29,53
toxic,25.9115393243,1.89137473818,13,11,24
bringdaruckus312,25.8961482234,4.91181907561,2,2,4
bunz,25.8333168092,2.18913934362,11,15,26
collin,25.8159901739,2.30629925038,9,9,18
webwipe,25.7776195402,3.38078551269,3,4,7
cmull,25.7757111871,3.44632193194,3,4,7
aces,25.7683599393,3.54713504703,3,6,9
bigbeaver,25.7382801215,1.3069676927,26,34,60
hoofydough,25.7113062928,4.91600928402,2,2,4
traiman,25.63103437,1.96177480032,11,14,25
lookalike,25.629556139,3.68195186892,4,4,8
baby legs,25.6118592381,2.55877236941,7,7,14
komodoninja,25.6076582822,2.67611374525,8,5,13
t brett,25.598239692,3.92970847819,3,4,7
chuck lubs,25.5606773425,5.02116683742,2,2,4
scratch,25.5567603835,1.86091145311,13,16,29
ace,25.5552569027,1.59988125202,16,21,37
justin,25.5477883665,2.70978460988,7,6,13
blmb,25.5261628189,4.73773122163,2,2,4
sebula,25.509929664,1.26142100697,29,35,64
funkykong,25.5009409927,4.87089798022,2,2,4
z-rex,25.4988855853,2.70802841915,5,8,13
prime,25.4981110983,1.6712709013,17,17,34
ttt,25.495052115,3.01944609215,3,6,9
meerkat,25.4912859276,2.38525786884,9,10,19
dingo boy,25.4752119328,4.29241790974,3,3,6
mixxedvegetables,25.4501743805,4.70204997659,2,2,4
tbq,25.442020139,3.35849930495,4,4,8
slappymcnutz,25.4381755499,1.91494975984,10,16,26
snowstorm,25.3934923152,4.93156978565,2,2,4
griffith,25.3636731485,1.38730627786,22,28,50
zbl_mystic,25.3388199478,5.23988847967,1,2,3
therapture_,25.3258278266,5.13054155253,2,2,4
salt,25.2941591503,4.96321040971,2,2,4
wazzberry,25.2821512309,4.73421942984,2,2,4
cortese187,25.2734327832,4.80713072026,2,2,4
swiftbass,25.2622368269,4.89216411198,2,2,4
moju,25.2541525953,5.20046083113,2,2,4
sj ryker,25.2541525953,5.20046083113,2,2,4
klms,25.2540556461,4.9265753216,2,2,4
nasian,25.2514494835,5.7913539601,1,1,2
sunvulcan,25.2511976505,1.54611458068,21,19,40
log,25.2450913061,2.95171183503,4,6,10
pandemonium,25.220578387,4.55214797812,2,2,4
zhu,25.2125827514,5.14797666842,1,2,3
blisstex,25.1886567921,2.95911099669,6,7,13
j9d2,25.1615677147,4.29789802798,2,2,4
wowzers,25.1586957156,4.68073409761,2,2,4
qubit,25.1257493202,4.91426923128,2,2,4
karlthemarx,25.1124033326,4.8206721687,2,2,4
hariballz,25.0865575559,3.39297205759,4,4,8
poptartplug,25.0826285291,5.11818158289,2,2,4
leavescat,25.0750936328,3.54077230734,4,4,8
doughnut,25.0743227204,4.89438716705,2,2,4
le_vinny,25.0670722257,2.13518777489,12,11,23
iheartqueso,25.0499826878,2.64253824416,8,9,17
gaggleforce,25.0457779237,5.12264762204,1,2,3
notlightningrunner,25.0432425227,4.65308130371,2,2,4
dolan,25.018968915,4.94617049301,2,2,4
beguiler,25.0181002617,5.04179208223,2,2,4
giraphe,25.0071253209,4.83941168776,2,2,4
shaddi,25.0059207114,2.79413743987,6,6,12
measthebeast,25.0022410141,2.09101693568,9,10,19
dsj,25.0009244495,2.78028322616,6,6,12
sussebass,25.0,8.33333333333,0,0,0
4eyez95,25.0,8.33333333333,0,0,0
wolfcry,25.0,8.33333333333,0,0,0
core,25.0,8.33333333333,0,0,0
price,25.0,8.33333333333,0,0,0
marfslayer 3000,25.0,8.33333333333,0,0,0
paul d,25.0,8.33333333333,0,0,0
donatello,25.0,8.33333333333,0,0,0
tweli,25.0,8.33333333333,0,0,0
vio,25.0,8.33333333333,0,0,0
falln,25.0,8.33333333333,0,0,0
phex,25.0,8.33333333333,0,0,0
link,25.0,8.33333333333,0,0,0
4sk,25.0,8.33333333333,0,0,0
zb,25.0,8.33333333333,0,0,0
baedough07,25.0,8.33333333333,0,0,0
mistertizye,25.0,8.33333333333,0,0,0
dezno,25.0,8.33333333333,0,0,0
[stg] overload,25.0,8.33333333333,0,0,0
refriedjeans,25.0,8.33333333333,0,0,0
duckpimp,25.0,8.33333333333,0,0,0
sabo,25.0,8.33333333333,0,0,0
neverpullout,25.0,8.33333333333,0,0,0
pat,25.0,8.33333333333,0,0,0
branchan,25.0,8.33333333333,0,0,0
the cfb,25.0,8.33333333333,0,0,0
oxycontin,25.0,8.33333333333,0,0,0
bronze_sun,25.0,8.33333333333,0,0,0
sambo,25.0,8.33333333333,0,0,0
bird-dawg,25.0,8.33333333333,0,0,0
lunchy,25.0,8.33333333333,0,0,0
s≈çcrates,25.0,8.33333333333,0,0,0
moft,25.0,8.33333333333,0,0,0
rice,25.0,8.33333333333,0,0,0
snazzy,25.0,8.33333333333,0,0,0
hail_sagan,25.0,8.33333333333,0,0,0
imperium,25.0,8.33333333333,0,0,0
djltheescapade,25.0,8.33333333333,0,0,0
benb,25.0,8.33333333333,0,0,0
redeagle2000,25.0,8.33333333333,0,0,0
acestarthe3rd,25.0,8.33333333333,0,0,0
esuma,25.0,8.33333333333,0,0,0
tdx,25.0,8.33333333333,0,0,0
bulldog,25.0,8.33333333333,0,0,0
k-phat,25.0,8.33333333333,0,0,0
kcon,25.0,8.33333333333,0,0,0
masterofzoroark,25.0,8.33333333333,0,0,0
chewy,25.0,8.33333333333,0,0,0
grunyan,25.0,8.33333333333,0,0,0
deep dimples,25.0,8.33333333333,0,0,0
royeric,25.0,8.33333333333,0,0,0
mouse,25.0,8.33333333333,0,0,0
monk,25.0,8.33333333333,0,0,0
karl,25.0,8.33333333333,0,0,0
kirbstomper,25.0,8.33333333333,0,0,0
mickeyrat,25.0,8.33333333333,0,0,0
stephanie,25.0,8.33333333333,0,0,0
rudedude,25.0,8.33333333333,0,0,0
lala,25.0,8.33333333333,0,0,0
ubll black mage,25.0,8.33333333333,0,0,0
king lui,25.0,8.33333333333,0,0,0
locamash,25.0,8.33333333333,0,0,0
pilot,25.0,8.33333333333,0,0,0
aperture,25.0,8.33333333333,0,0,0
emon,25.0,8.33333333333,0,0,0
smashlopez64,25.0,8.33333333333,0,0,0
da bear,25.0,8.33333333333,0,0,0
thomas,25.0,8.33333333333,0,0,0
birdybirds,25.0,8.33333333333,0,0,0
foxnard,25.0,8.33333333333,0,0,0
puddn,25.0,8.33333333333,0,0,0
bus,25.0,8.33333333333,0,0,0
hyperbole,25.0,8.33333333333,0,0,0
oljace,25.0,8.33333333333,0,0,0
sylveonbae,25.0,8.33333333333,0,0,0
patty-wagon,25.0,8.33333333333,0,0,0
sharktoast,25.0,8.33333333333,0,0,0
werewyatt,25.0,8.33333333333,0,0,0
fractal,25.0,8.33333333333,0,0,0
shyguyking,25.0,8.33333333333,0,0,0
awesomethesauce,25.0,8.33333333333,0,0,0
jobook,25.0,8.33333333333,0,0,0
flash,25.0,8.33333333333,0,0,0
dr.shots,25.0,8.33333333333,0,0,0
miken,25.0,8.33333333333,0,0,0
l0n3r,25.0,8.33333333333,0,0,0
big d [hamiel],25.0,8.33333333333,0,0,0
urpasmash,25.0,8.33333333333,0,0,0
lukem,25.0,8.33333333333,0,0,0
travkid,25.0,8.33333333333,0,0,0
bund,25.0,8.33333333333,0,0,0
name,25.0,8.33333333333,0,0,0
dr. light,25.0,8.33333333333,0,0,0
cr0ak,25.0,8.33333333333,0,0,0
malkasaur,25.0,8.33333333333,0,0,0
sleeh,25.0,8.33333333333,0,0,0
fireberts,25.0,8.33333333333,0,0,0
nikku,25.0,8.33333333333,0,0,0
brendanhall,25.0,8.33333333333,0,0,0
nokto,25.0,8.33333333333,0,0,0
reb,25.0,8.33333333333,0,0,0
little bill,25.0,8.33333333333,0,0,0
scuttlebug jamboree,25.0,8.33333333333,0,0,0
coldo,25.0,8.33333333333,0,0,0
afro,25.0,8.33333333333,0,0,0
ldz,25.0,8.33333333333,0,0,0
squallette,25.0,8.33333333333,0,0,0
dude,25.0,8.33333333333,0,0,0
juno,25.0,8.33333333333,0,0,0
xbc30ep450,25.0,8.33333333333,0,0,0
mojn,25.0,8.33333333333,0,0,0
ferrero64,25.0,8.33333333333,0,0,0
the amazing busterino,25.0,8.33333333333,0,0,0
brentosfreshness,25.0,8.33333333333,0,0,0
bedgar,25.0,8.33333333333,0,0,0
pvc,25.0,8.33333333333,0,0,0
mimi,25.0,8.33333333333,0,0,0
filet,25.0,8.33333333333,0,0,0
eltiti,25.0,8.33333333333,0,0,0
adubz,25.0,8.33333333333,0,0,0
rf!,25.0,8.33333333333,0,0,0
mahie,25.0,8.33333333333,0,0,0
dunos_,25.0,8.33333333333,0,0,0
jarl,25.0,8.33333333333,0,0,0
hans_mawell,25.0,8.33333333333,0,0,0
sheen,25.0,8.33333333333,0,0,0
ozymandias,25.0,8.33333333333,0,0,0
electricgazelle,25.0,8.33333333333,0,0,0
yung,25.0,8.33333333333,0,0,0
sd master,25.0,8.33333333333,0,0,0
voidstar,25.0,8.33333333333,0,0,0
k8,25.0,8.33333333333,0,0,0
magitech,25.0,8.33333333333,0,0,0
sadfaps,25.0,8.33333333333,0,0,0
madguy,25.0,8.33333333333,0,0,0
levity,25.0,8.33333333333,0,0,0
gaon!,25.0,8.33333333333,0,0,0
zane,25.0,8.33333333333,0,0,0
god,25.0,8.33333333333,0,0,0
pastor,25.0,8.33333333333,0,0,0
dobermen?,25.0,8.33333333333,0,0,0
redribb0n,25.0,8.33333333333,0,0,0
thac0,25.0,8.33333333333,0,0,0
johnnyfight,25.0,8.33333333333,0,0,0
tarn,25.0,8.33333333333,0,0,0
goomah,25.0,8.33333333333,0,0,0
spade,25.0,8.33333333333,0,0,0
hypertj,25.0,8.33333333333,0,0,0
ajp,25.0,8.33333333333,0,0,0
spicky,25.0,8.33333333333,0,0,0
purplefox,25.0,8.33333333333,0,0,0
flat nat,25.0,8.33333333333,0,0,0
chai,25.0,8.33333333333,0,0,0
schmerka berl,24.9885413474,2.82459731238,5,8,13
sandman,24.9868306312,4.55829139411,3,2,5
imdabes,24.9544618082,4.9329171002,2,2,4
yass2queen,24.9521629583,5.55029356187,1,2,3
lou_sanus,24.9510909152,1.45619980962,21,24,45
tootmoses,24.9372224841,4.0564441817,3,4,7
no~m,24.9327875816,1.86729738003,14,14,28
damp,24.9288383086,4.83408335869,2,2,4
milleneum,24.9162588384,2.11625238286,10,11,21
girl,24.8919002125,4.65131565094,2,2,4
p21/c,24.886268997,2.59381623741,5,11,16
jc_chill,24.8816904935,4.66007647926,2,2,4
village mascot,24.8720156735,2.21532459819,11,14,25
biz,24.8643355236,3.48382755041,3,4,7
olikus,24.8319854561,4.49142793828,2,3,5
pidgezero_one,24.8030371179,4.92260328023,2,2,4
dasit mane,24.795392969,5.2966392227,1,2,3
7blanks,24.7857655914,4.03426846924,3,3,6
barron,24.7540506092,5.1596431797,2,2,4
hayrow,24.7461387175,5.58597256249,1,2,3
tafokints,24.7284273966,5.97681198372,1,1,2
purple fox,24.719393349,4.59710626235,2,2,4
pintoa,24.7176684116,2.51586377015,8,9,17
dankestdad,24.6964841447,3.68821338991,4,4,8
alex,24.6893879038,3.91731584124,3,5,8
yeye,24.6680413236,4.25708493963,2,4,6
dusttin,24.6672068801,2.67151786737,6,9,15
daddy's milk,24.6532877206,4.1259442269,3,4,7
blueman,24.6508115283,4.14280586446,3,4,7
soulbroker,24.6490965711,4.77612071047,1,2,3
tetsu0,24.6262993259,5.03796166079,2,2,4
dount,24.6060569127,4.09402006283,3,3,6
pupperina,24.5917780168,4.66831085229,2,4,6
whuck,24.5828430357,4.01651529369,2,3,5
drinkwildturkey,24.5809226796,3.38036585241,4,4,8
hotpocket,24.5626509381,2.50778575573,8,10,18
thissidedown,24.5513665815,5.43925573599,1,2,3
cashhole,24.5465427382,5.42607510836,1,2,3
et,24.5353946714,1.87351108036,10,18,28
mmneggs,24.5296138705,3.36896584499,2,6,8
fanboy,24.4829318415,5.72278129829,1,2,3
collin the conqueror,24.4582480014,5.06356359914,2,2,4
tom bombadil,24.4540253577,3.32753399113,4,5,9
slippypickle,24.440038935,4.31775025467,2,4,6
papaghanoush,24.4281354527,3.3741752347,3,4,7
reese,24.4125060803,4.45102394199,2,2,4
jazzy jinx,24.3888989225,4.61063078292,2,2,4
luigikid,24.3723373415,4.99696619184,2,2,4
enemajoe,24.3300810327,3.25778557145,4,4,8
tauvalian,24.3283622006,5.04985079081,2,2,4
gamer4life,24.3124427085,4.62809259589,2,2,4
byff,24.3098701516,4.42202933059,2,2,4
natural brother,24.2847807123,2.78874730408,5,8,13
pettanko-senpai,24.2167858418,2.69494868099,7,6,13
satch,24.1958546769,5.01118863784,2,2,4
esid,24.1691395514,2.14328880092,10,9,19
monkey,24.1678037296,2.07186486253,10,13,23
smashg0d,24.1473408161,5.37571815839,1,2,3
drewgong,24.1137442572,1.78262781785,13,16,29
moustasher,24.1067258528,1.7349923198,14,19,33
shamsavior,24.1010510347,2.14839405221,7,12,19
chicken,24.0952232137,2.96901209715,5,7,12
chevrium,24.060455993,3.68161450092,3,4,7
principal coffee,24.0523974811,2.55581014845,9,6,15
pzero39,24.0350842065,2.12396188407,10,15,25
skrull,24.031140001,4.94321833813,2,3,5
staysleepin,24.020632642,2.87759928602,4,8,12
kevine,23.9323230733,5.5949095219,1,2,3
costaricancool,23.9301440452,4.56037777054,2,3,5
savior,23.8957535633,4.9539912595,2,2,4
wubbs,23.8850708608,4.93788155375,2,4,6
camerino,23.8729535734,4.18117276001,2,4,6
ders,23.8527904264,3.70328815407,5,4,9
jaquarium,23.8404794066,5.04087719999,2,2,4
khakis,23.8195168002,4.66275126303,2,3,5
probers,23.8106637966,4.6725758398,2,2,4
grahamaglam,23.7989003755,1.97937260383,8,14,22
lotus eater,23.7497290802,2.80449633101,5,6,11
hunter,23.74622392,1.7067546412,16,17,33
dirtcruncher,23.7325698907,3.33912101717,4,6,10
mr. biz,23.7210641953,5.05089869586,2,2,4
monad,23.7192793454,1.50526017854,17,31,48
dsyr,23.7155658162,3.86650177106,2,2,4
gaijilla,23.7148498801,5.87687390354,1,2,3
sombrero,23.7080725421,5.41496815893,1,2,3
cmac,23.7006667101,3.29595175001,4,6,10
truffleshuffle,23.6788769285,4.52693030002,2,3,5
zenaga,23.6761009151,5.50042648943,1,2,3
icho,23.6704412132,4.88551887292,2,2,4
waldo,23.6564987855,4.20129737764,2,3,5
gera,23.6559792327,5.56236014964,1,2,3
b.i.,23.6355291603,1.96142687481,9,13,22
sk,23.617401212,5.63947001185,1,2,3
kurow,23.6060908902,7.48344444323,0,1,1
puncayshun,23.6056117362,3.55282067393,4,3,7
majin_bukkake,23.5743910106,1.95031301967,11,16,27
searing scar,23.5687782599,4.40967730524,2,4,6
twan,23.5547296601,3.21473977536,5,3,8
izoo,23.5371695413,5.42181231484,1,2,3
capos,23.5326200247,1.1163962976,43,54,97
wheels,23.5278549227,2.18340819924,8,7,15
jinjo,23.521719914,5.51985391467,1,2,3
file,23.5015906155,2.60688702049,8,5,13
moze,23.4810579158,4.99386053707,1,2,3
arctic,23.4684294881,5.40148296815,1,2,3
derstuk,23.435352976,2.17296532015,10,12,22
kingkool,23.4129278833,2.45698525274,8,10,18
pochilin,23.3686415636,3.89578154083,3,5,8
bre,23.3657056122,2.34949644305,7,9,16
steamfriedasian,23.3621246951,5.73391255533,1,2,3
rawdog,23.3582773514,5.06417344374,2,2,4
chronicmexican,23.3412410855,2.44574377964,6,12,18
wal,23.3198178163,5.72279818,1,2,3
sph,23.27614359,4.5186933381,2,3,5
-philip coast philip-,23.2491175189,5.23174393906,1,2,3
sonicfuzz,23.2272037183,2.3525523905,9,11,20
thrillhouse,23.2256191933,1.8361387965,11,17,28
jaapoh,23.1992644683,3.56525073948,3,4,7
neth,23.1861020266,5.49320539377,1,2,3
bhol,23.1620605194,2.26239400405,8,11,19
qtip,23.1471201424,5.96320374501,1,1,2
dwreck,23.1427050378,5.50870913819,1,2,3
garv,23.1294585554,3.96079569783,2,2,4
ditto,23.1257689022,2.33063577585,7,11,18
clefairy as mew,23.0927379524,4.95371121424,2,2,4
xanz,23.0627844379,5.12803049989,1,2,3
aguos,23.0598851704,5.54794149378,1,2,3
minymidge,23.0504825298,2.17972817626,7,16,23
chino san,23.0411667529,5.40011006648,1,3,4
ardent rage,23.0390518825,5.33053236201,1,2,3
dex,23.008219104,7.26024885505,0,1,1
matt,23.0021492626,3.2345860881,3,5,8
kman,22.9932321123,5.67901093998,1,2,3
gibbles,22.978672069,5.00595290453,1,2,3
egg,22.9293421814,7.22593336319,0,1,1
bimbo,22.9224512853,3.06351212304,4,5,9
ajbcdefg,22.9083763397,1.43940299727,22,29,51
billbacon420,22.9049083462,1.42605828295,20,31,51
xif,22.8945806108,7.21434095547,0,1,1
biscuit,22.8662146651,5.74469940782,1,2,3
hotspank,22.8401786479,1.67020529067,16,22,38
racilor,22.832366652,4.68350818701,1,4,5
elu,22.8316352488,2.06498572996,11,18,29
bean,22.8274450923,1.75223541585,12,25,37
zibba,22.8170969194,7.24300767435,0,1,1
pluto,22.7862654365,5.59896835446,1,2,3
lordtoko,22.7758597438,2.74979825182,5,7,12
cooljoe,22.7688824377,5.25543564081,1,2,3
silver,22.7663007028,3.15806714803,4,6,10
tmakk,22.7634565393,4.043579721,2,4,6
bodacious,22.7456335897,4.10770698892,3,4,7
green eggs and spam,22.7230024839,4.04186604613,2,4,6
goosewithsocks,22.7150512562,1.56157015081,18,23,41
bonerstorm,22.7131543348,5.03759629022,1,2,3
andy,22.7130039516,3.12886499955,3,6,9
bflakes,22.7055170601,1.92137027658,11,16,27
greenblob,22.7005985788,2.93981352799,4,7,11
dankpank,22.6997716597,1.37375290959,23,33,56
verwaltung,22.6867102224,5.67101579923,1,2,3
drewskii55,22.6773296708,7.1998936357,0,1,1
tangerine,22.6496651182,2.0126084599,13,15,28
boh,22.6263883891,5.22409885802,1,2,3
foda,22.6111016292,1.94352067908,11,14,25
nanagens,22.6085615051,2.8392496051,7,5,12
masquerade,22.587628892,5.41235818274,1,2,3
robnu,22.577584328,5.27196545584,1,3,4
hotahota,22.5683629089,2.7403029174,7,7,14
bottle opener guy,22.5653454992,3.43760166945,4,4,8
cuppajoe,22.5614711416,3.98912966001,3,4,7
asaaj,22.5541453473,3.19697897396,4,4,8
nuggzy,22.553497257,5.04206817249,2,2,4
brny,22.5510624065,5.27951905089,1,2,3
evals,22.5497261156,5.26109394584,1,2,3
duncs,22.542579771,1.58716874643,19,25,44
schlag,22.5295736344,5.64093463869,1,2,3
panda,22.516062019,2.87029539933,5,9,14
keagsbsmashin,22.505682607,4.93161471885,2,2,4
zhao_guang,22.4941873647,5.27374026539,1,2,3
chiefreaper,22.4936385525,5.37551826948,1,2,3
stylisland,22.4904829249,4.90402526519,1,2,3
aisengobay,22.4822646283,5.03822662096,1,2,3
lldl,22.4754387364,5.54602983821,1,2,3
train_town,22.448633329,5.33171687342,1,2,3
bohemian milk,22.4410234019,5.64191828862,1,2,3
mourin,22.436189438,5.53322447519,1,2,3
momdameatloaf,22.4306897652,2.75579127447,5,6,11
rythemretrn,22.4257927027,5.54390698698,1,2,3
nigel_thornberry,22.4244050737,5.22861340634,1,2,3
okay,22.4182441462,5.79814227241,1,3,4
leaf fc,22.4088136667,3.30055707137,4,6,10
rgood,22.3757280256,5.20523093539,1,2,3
cyan can,22.3695283141,3.54363126097,3,6,9
tokaji,22.3418384892,5.72549549374,1,2,3
maaron,22.3235126558,5.2279102694,1,2,3
bombproof,22.3135623736,3.12783171833,4,7,11
h00n,22.2999462743,3.56090337116,2,4,6
handles,22.2953388589,3.05765523794,4,7,11
widdy,22.2953097257,1.7711936033,14,27,41
yakal,22.2950630033,5.45881954507,1,2,3
rebel scum,22.292024414,3.35144994347,3,5,8
zergos,22.2873516133,3.27996764609,4,6,10
tipc,22.2782864592,2.85397157482,4,8,12
reckless,22.2777886196,5.54771180862,1,2,3
happens,22.2497714505,3.38324281611,3,5,8
adrian,22.2449221962,5.4939042246,1,2,3
sun vulcan,22.2335303792,3.97602233259,2,4,6
geekliftus,22.2334848055,5.51993490319,1,2,3
prism,22.1917210576,5.76046429635,1,2,3
cbones,22.1847462276,5.18344188026,1,2,3
banana fiend,22.1744614877,5.07750578306,1,2,3
grrg,22.1709429178,2.56970803182,6,11,17
toez,22.168164857,5.18214438995,1,2,3
squible,22.1667460858,2.73910227407,6,7,13
moonshoe,22.166587333,1.22771655035,30,49,79
dr.yonz,22.1384961443,2.19357949187,8,10,18
hsf,22.1332592745,5.19764774349,1,2,3
ocelot,22.1196690384,2.14022795401,6,17,23
omar,22.1027125746,4.53461108477,2,4,6
mickeyo64,22.0888950697,5.0311026225,1,3,4
giraffe,22.0832446758,5.52720444839,1,2,3
nikademiks,22.0449313695,3.44977386444,5,3,8
crip,22.0417499629,5.72015962435,1,2,3
honeybadger,22.0417499629,5.72015962435,1,2,3
mrryanness,22.0264904272,3.72581344649,3,7,10
hbrw-hammer,21.989450955,5.19683618143,1,2,3
mrpoo,21.9694395301,5.5090539933,1,2,3
zarc,21.9523180178,5.3661603852,1,2,3
mr. tit,21.929236407,2.54818862359,5,7,12
moonlight,21.9041327712,2.72484039789,4,9,13
hamburglar,21.9029378728,5.45427822857,1,2,3
han,21.8966597569,5.31977588561,1,2,3
kzidek,21.8867795024,5.53430238446,1,2,3
eggmcmuffin888,21.8817810439,2.50385682435,5,9,14
papasquat,21.8473786751,1.62517553776,12,27,39
jlo,21.8297972181,2.65324949724,7,8,15
seantos,21.7696914113,2.04188630708,10,17,27
sebson,21.7530840691,4.85632383527,1,3,4
kaddy,21.7448383797,6.97871477739,0,1,1
paco [larkin],21.7226250865,5.45614516154,1,2,3
kristoff,21.7186201828,1.90882333408,12,19,31
pizzajokes,21.7162054905,5.50815225737,1,2,3
iceking,21.6990665822,2.75555381699,5,12,17
burnt out ninja,21.6867950646,5.49425252058,1,2,3
fawnco,21.6867950646,5.49425252058,1,2,3
cardoso,21.6780577038,5.47180539926,1,2,3
keatsta,21.6661328493,5.27091244792,1,2,3
h2o,21.6545792433,2.88114638768,6,6,12
gumbolaya!,21.6434793433,5.28700972786,1,2,3
dair,21.6163935474,3.18091719706,4,4,8
halffulla,21.5918291983,3.47708102369,3,5,8
dax$,21.584803573,2.65338997848,6,6,12
calzum,21.5671007742,5.3351678636,1,3,4
elated,21.5646200511,2.05879727439,9,16,25
weirdy man,21.5408384478,5.33808902253,1,2,3
slartibartfast42,21.5328392932,4.28071789839,2,4,6
evab,21.5281310611,5.45654170068,1,2,3
joebro,21.5191080869,6.84943611191,0,1,1
l3w!,21.5121865877,5.11210096522,1,2,3
ondas,21.5108037264,3.48943553215,3,5,8
sadu,21.5083034504,5.57372398202,1,2,3
zombie!,21.5047657545,5.52858492613,1,2,3
zwephy,21.5047657545,5.52858492613,1,2,3
the professor,21.5047657545,5.52858492613,1,2,3
kossismoss,21.5047657545,5.52858492613,1,2,3
jirachinick,21.5047657545,5.52858492613,1,2,3
glennwood,21.5047657545,5.52858492613,1,2,3
anathema,21.5047657545,5.52858492613,1,2,3
trevman,21.5027061159,5.10402665286,1,2,3
yolochi,21.499178311,2.39018022144,7,13,20
second boss,21.4580056474,3.52002362037,3,4,7
xiivi,21.4560393361,2.85032957782,5,9,14
jmabate,21.4375021927,5.28753891929,1,2,3
macintosh,21.4364867797,3.43008133471,3,6,9
fearlesscaboos,21.42201449,5.32006876842,1,2,3
tubby!,21.4209962926,4.56376971604,1,4,5
v-bomber,21.4000216092,4.19284654502,2,4,6
gray,21.362863014,2.66383755913,5,8,13
napkins,21.3422581477,5.51129103904,1,2,3
whoopiecow,21.3422581477,5.51129103904,1,2,3
bubby,21.3396390978,5.35310713357,1,2,3
elrond,21.3289292828,2.44997891096,6,13,19
boink,21.3077692111,3.33514793817,4,5,9
pikasneeze,21.2753068981,2.75384467938,5,6,11
fish,21.2719772571,7.11032076085,0,1,1
chunky's cheese,21.2316788949,6.41568964812,0,2,2
minusev,21.2295305428,7.09832421852,0,1,1
frostbyte,21.2134598043,3.47493516988,3,7,10
a dog,21.2006338247,5.2780201564,1,2,3
bawdbabe87,21.1814872601,2.25759754203,10,14,24
dugdiaz,21.1570521575,2.94163714855,3,7,10
jdp,21.1355362002,5.10890700473,1,2,3
blue bear,21.1002964099,5.55587524657,1,2,3
peaceful soujourner,21.0989906619,5.11510453997,1,2,3
frog,21.0723534016,3.24787488236,4,7,11
shasta,21.070209472,5.51002169606,1,2,3
kavon,21.070209472,5.51002169606,1,2,3
hungrybox,21.0574613726,4.4892952341,2,4,6
fingerblast,21.0244306424,4.56662555567,2,2,4
zouzy,21.0183644292,5.5600200027,1,2,3
mizbiz,21.0161375317,3.26223636284,4,4,8
hipo,20.9929052597,5.2619484039,1,2,3
doby,20.9352945902,4.83891331403,1,2,3
catastrophe,20.8888223088,3.6975526262,3,4,7
fuzzyness,20.8795884661,5.24650222457,1,3,4
tallboi,20.8642414817,6.62027905668,0,1,1
dr combos,20.860552023,3.27349555618,2,8,10
big tone,20.8343383913,7.05669011338,0,1,1
apparition the ambassador,20.8170548195,1.20504853311,25,55,80
java boy,20.8111687051,5.50715471621,1,2,3
cookie,20.805892934,6.2741434945,0,2,2
ttp,20.7895102289,3.45128481965,3,6,9
dankey kang,20.7891251298,2.15860515009,7,17,24
static,20.7695841745,3.6129222732,3,5,8
yungpurp,20.7651349203,6.66638790782,0,1,1
mojo,20.7580618334,5.19829938861,1,2,3
zach777,20.7547881447,6.43828154407,0,2,2
lalo,20.7442235802,4.1391258757,2,4,6
queso,20.738421778,2.82803337447,3,8,11
eliot,20.73831818,4.91080570713,1,5,6
lucky_hamburger,20.7375249306,2.94348718454,4,7,11
fork?,20.735278577,4.94201882121,1,3,4
teflon ron,20.6964735531,3.30608752561,2,6,8
zerobombjake,20.690095948,2.05798625407,9,15,24
buttery adachi,20.67245849,4.63882940247,1,3,4
weedlypuff,20.655668381,2.84750066607,4,10,14
zad,20.6338221765,3.37435892767,3,7,10
brotherly,20.6227848246,2.76464786587,4,7,11
silent skyler,20.60416798,7.17147558733,0,1,1
captain murphy,20.60416798,7.17147558733,0,1,1
benbook,20.60416798,7.17147558733,0,1,1
lonk,20.60416798,7.17147558733,0,1,1
penance,20.60416798,7.17147558733,0,1,1
josiab,20.60416798,7.17147558733,0,1,1
5000candlesinthewind,20.60416798,7.17147558733,0,1,1
nyani,20.60416798,7.17147558733,0,1,1
kayo,20.60416798,7.17147558733,0,1,1
akito555,20.60416798,7.17147558733,0,1,1
thissideup,20.60416798,7.17147558733,0,1,1
nfreak,20.60416798,7.17147558733,0,1,1
4 phri,20.60416798,7.17147558733,0,1,1
nannose,20.60416798,7.17147558733,0,1,1
drewjames,20.60416798,7.17147558733,0,1,1
uprowr,20.60416798,7.17147558733,0,1,1
bunmira,20.60416798,7.17147558733,0,1,1
ragingcherry,20.60416798,7.17147558733,0,1,1
sfat,20.60416798,7.17147558733,0,1,1
k-man,20.60416798,7.17147558733,0,1,1
phalanx,20.60416798,7.17147558733,0,1,1
akajumo,20.60416798,7.17147558733,0,1,1
changed man,20.60416798,7.17147558733,0,1,1
mystery,20.60416798,7.17147558733,0,1,1
yung god,20.60416798,7.17147558733,0,1,1
fs shampoomaster,20.60416798,7.17147558733,0,1,1
sherb,20.60416798,7.17147558733,0,1,1
jad,20.60416798,7.17147558733,0,1,1
nuro,20.5840982794,5.43713762519,1,2,3
maher,20.5765130073,5.42879585881,1,3,4
2%gay,20.5677871593,4.65028801644,1,3,4
mikeyp,20.5458411129,2.64034615982,5,10,15
moist,20.5281445459,4.25078653283,2,4,6
flatline,20.5164882806,5.24452888369,1,2,3
icactusdog,20.4983297602,1.16465015904,31,76,107
joel,20.478935873,2.79740205502,5,8,13
thenuge,20.4674116909,5.0330326619,1,3,4
jaws,20.4624848475,5.35841658628,1,2,3
three beers,20.4558344146,2.70872153186,4,8,12
heartsdealer,20.4341694035,4.22058234979,2,4,6
multiball,20.4281843612,2.35877064022,7,12,19
voff3,20.4194222364,7.01037721982,0,2,2
barrels,20.4071695798,3.86199847453,2,6,8
mr baninawi,20.3728378566,4.51416431387,1,2,3
throwz?!,20.3699145043,5.17078183222,1,2,3
homemadewaffles,20.3612733202,6.92690169084,0,1,1
el rabbito,20.3414295746,5.22933943015,1,3,4
hero,20.3003305973,6.88831159169,0,1,1
cormander,20.2908207141,2.69388802197,4,12,16
spunker,20.2758495281,6.64019935679,0,2,2
nich,20.2703414274,3.29349458613,3,10,13
e-jager,20.2487242786,4.96384536252,1,3,4
acerunner,20.2434912975,3.82892011382,2,5,7
caelan,20.204195046,7.0610632401,0,1,1
muse,20.190647659,2.20277491649,8,14,22
shug,20.1748734994,3.31155720936,3,8,11
jag,20.1701833917,3.03064843418,4,8,12
papa,20.1427440716,3.0490730024,4,8,12
izze,20.1412467053,4.69874266476,1,4,5
mjim,20.0885900525,2.69803777878,4,12,16
kiwi,20.0810067627,3.22971514224,2,7,9
howdy,20.0702486298,2.07782495883,11,16,27
aegeze,20.0452031459,3.37681572663,3,5,8
fritz wethermyb,20.0423261572,6.17887135694,0,2,2
zephr,20.0265585836,4.95258600964,1,3,4
mighty afro dighty,20.0124969649,3.66848628564,2,4,6
b vu,19.9967578453,6.568690373,0,1,1
fiasko,19.9729112677,4.85580827797,1,3,4
depressed eagle,19.9668557046,4.71517261952,1,3,4
accru fenix,19.9613597327,2.89708841516,3,10,13
stark,19.9302051485,2.13481208164,7,15,22
tallyshell,19.9299857968,5.03695443852,1,2,3
weatherman,19.9134632191,6.05273787218,0,3,3
bunme,19.8921627682,4.3301126259,1,3,4
mikelangelo,19.8826413423,6.45276084535,0,2,2
kingcake,19.8821431813,3.92362364515,1,3,4
pika,19.8665160974,4.50476058035,1,4,5
pokmo,19.8588809573,2.97672589641,3,8,11
danny,19.8557110232,6.8417967732,0,1,1
frogman [charette],19.8470685379,6.53515646093,0,2,2
nineball,19.8422182213,3.00284218357,3,7,10
king robin,19.8264780176,5.18911180688,1,3,4
spt,19.7683262621,6.36258626328,0,2,2
cagt,19.7438192065,1.61972090222,16,27,43
dad's musical erasers,19.7265611929,6.32158021281,0,2,2
maximum can,19.7074645355,6.13243529775,0,2,2
james bong,19.6930797998,3.04895518486,4,9,13
memez,19.6329168238,3.27505473753,3,5,8
godspeed,19.6323868729,6.59012829512,0,2,2
sebastian,19.5830654512,2.91585063675,4,8,12
rogue1wasjustok,19.5369489136,2.87699767424,3,8,11
kuso,19.4888408706,5.19655189281,1,3,4
danno,19.4480883685,5.26348120732,1,2,3
yaron,19.4446647988,3.68169141706,1,6,7
dimension,19.4061385287,6.20651346822,0,2,2
goose,19.371372428,3.65122198951,2,6,8
fred,19.3466105456,4.81894184002,1,4,5
diveo,19.3406492658,2.22892556961,6,18,24
lil devil55,19.3372656866,6.50140744992,0,2,2
k,19.3329858189,6.13290633721,0,2,2
fumofuu,19.3003820949,6.70094005858,0,1,1
qu'importe,19.2889477971,3.23304912956,4,4,8
jive turkey,19.2766685957,4.23980905252,1,4,5
veen,19.2649590252,6.50769593739,0,1,1
houndour,19.2356554243,4.73650340573,1,5,6
magic,19.218129086,3.12444321155,3,5,8
dixoncider,19.2008458807,2.99012715154,4,9,13
krypto,19.1828664971,4.81567058623,1,4,5
russellsprouts,19.1536542378,1.27355807633,24,69,93
rush,19.1311277679,2.87822451122,3,9,12
supernuggit,19.1152119522,2.47416501098,5,12,17
kosher,19.1118554661,2.31727919266,6,12,18
missingn0,19.107855309,6.09023405989,0,2,2
laugh,19.1010739474,2.80710434092,4,10,14
bluebear,19.0929335108,2.6766027826,5,10,15
slatts,19.0593280194,1.75680941784,10,27,37
brown_omega253,19.0466076843,6.33270598276,0,2,2
jiffypop23,19.0360198867,3.35796007164,3,6,9
bleachfanboy4life,19.0345060525,5.04026040602,1,3,4
rockmix,19.012499914,6.51236605226,0,2,2
fry,19.0095514552,2.00655339289,8,22,30
esmod,19.004211349,6.50799591405,0,2,2
fs mook,19.0028728103,6.87267909617,0,1,1
skubtard,19.0028728103,6.87267909617,0,1,1
dcmaster,18.994474632,3.29454341215,3,6,9
husker,18.9729848694,4.21021265239,1,5,6
guccipivotmaster4000,18.9347382351,6.43705129894,0,2,2
ego,18.9220364506,6.43080985891,0,2,2
precookedbread,18.9052180392,6.13144583345,0,2,2
ensindic,18.9004963682,2.82314476994,4,11,15
robslabgod,18.8761845716,6.18833956004,0,2,2
engdrew,18.8706945128,2.75432892624,3,9,12
crazy_cubano,18.8656408574,2.27658652672,7,11,18
quentendo,18.812561844,6.15249422164,0,3,3
muthalova7,18.8064407194,3.29834247803,4,5,9
blizz,18.7928519856,6.79635578797,0,1,1
turtlpower,18.7895018776,6.35251859374,0,2,2
neat,18.7809989994,2.45501356352,4,17,21
bananabolts,18.7731183833,4.13323786869,1,5,6
mr.e [rohr],18.7703709704,6.52341434227,0,2,2
littlespoon,18.7700617181,6.35643512664,0,2,2
flare,18.7496637048,4.82067504917,1,4,5
iacme,18.7490090584,5.93999693415,0,2,2
jackmehoff,18.7281982334,6.30609176445,0,2,2
polarbair,18.6966678897,2.19558311431,8,18,26
duck chris,18.6843486974,6.48895532793,0,2,2
kali mist,18.6688594886,4.74235294333,1,5,6
jgin,18.6499404283,5.92823691426,0,2,2
captain hook,18.630130335,3.02413291055,3,6,9
takuto,18.618021382,2.5302402609,5,10,15
youtwo,18.6056078068,6.49184921396,0,2,2
cracker jones,18.5903746915,1.60470200085,13,32,45
kieuarty,18.5698620283,6.44984865492,0,2,2
kl3an,18.5588529466,6.38820575423,0,2,2
r.o.m.,18.5588529466,6.38820575423,0,2,2
qerbstomp,18.5482432297,3.12293726685,3,12,15
pokeiman_master,18.5453427898,6.44229379669,0,2,2
tdp,18.5322048421,6.27670782881,0,2,2
ltdan,18.5288936737,4.30114958634,1,4,5
lecceo,18.5224563478,6.04122538682,0,2,2
nathansandwich,18.5181367777,3.35893033655,3,7,10
failcant,18.5036619979,6.53954925511,0,1,1
tbone,18.4739919389,6.26372813517,0,2,2
nagurnimaster,18.4700890997,6.22509745584,0,2,2
superkirby,18.4611593024,6.07126152759,0,2,2
ender,18.4394901651,3.08681923971,5,6,11
myninja,18.4379650351,4.38094189367,1,4,5
lloyd-black,18.4304932356,6.11789831324,0,2,2
professortoke,18.4238290898,6.40483679046,0,2,2
crazycat,18.4069949275,3.17530829367,3,6,9
stdangerous,18.3869320511,6.13518467314,0,2,2
big d squirrels,18.3841716709,6.39539792275,0,2,2
swerve,18.3712842098,6.39033870841,0,2,2
master jay,18.3609401588,6.39052231831,0,2,2
shwang,18.3577767565,6.2521714548,0,2,2
albinosaurus,18.3469169827,6.16080501298,0,2,2
nami,18.3449675847,6.12168390994,0,2,2
charlie harper,18.3330999134,6.38313840111,0,2,2
reno,18.3279617969,5.79486931509,0,2,2
hasme,18.3032643844,5.59458002083,0,3,3
quinceprince,18.2944270184,6.23604937648,0,2,2
pugdaddyfre$hlyfeogg*flva,18.2942489328,6.22238929289,0,2,2
arcangel,18.2903426969,4.28569202842,1,5,6
silky johnson,18.2723486779,3.28098369561,2,8,10
dance!!,18.2367878139,4.26202260026,1,5,6
jesusisking,18.1886170845,6.12729931389,0,2,2
xlax,18.1874527175,4.71791538095,1,4,5
blues,18.1749825261,4.8151649564,1,4,5
tangpootie,18.1364119855,2.52596160262,5,12,17
elmustachio,18.1178019254,6.11091424803,0,2,2
shawarma habibi,18.1031928086,3.43346911477,2,6,8
jdeezel,18.096134607,6.31705839702,0,2,2
chi-fence,18.0777688254,4.39863423513,1,4,5
tylenol jones,18.0758497583,6.32077271178,0,2,2
avian,18.0712867461,6.31842389736,0,2,2
warmachine1919,18.0428187692,6.46387437135,0,2,2
sweaters,18.0428187692,6.46387437135,0,2,2
g-rabbit,18.0117795568,2.54074662703,5,12,17
erk,18.0081957112,6.30096749365,0,2,2
yam$,17.9980023599,6.32119878345,0,2,2
firefly,17.9980023599,6.32119878345,0,2,2
astropancakes,17.9980023599,6.32119878345,0,2,2
jpoptosis,17.9980023599,6.32119878345,0,2,2
snack?,17.9980023599,6.32119878345,0,2,2
jpeghero,17.9980023599,6.32119878345,0,2,2
drhino,17.9980023599,6.32119878345,0,2,2
lexi,17.9729324925,5.92956035083,0,2,2
lights,17.9722012086,6.29535962389,0,2,2
frame,17.9686592375,2.36942614875,4,19,23
beaver,17.9564848443,6.3115571796,0,2,2
√°1,17.912664972,2.59017406586,2,11,13
armagreggon,17.8906806857,3.49330185733,2,5,7
ebay,17.8407852112,6.26851580688,0,2,2
pajhomas,17.8353897044,4.2804828678,1,4,5
jfm,17.8270005524,6.29388615473,0,2,2
bc_burns,17.8270005524,6.29388615473,0,2,2
armor,17.8270005524,6.29388615473,0,2,2
chaos pro,17.8270005524,6.29388615473,0,2,2
legoman,17.8270005524,6.29388615473,0,2,2
dhir,17.8270005524,6.29388615473,0,2,2
mulkster,17.8270005524,6.29388615473,0,2,2
akiva,17.8270005524,6.29388615473,0,2,2
brambramjam,17.822280012,6.04584647594,0,2,2
ejmp,17.8013773459,6.4139643899,0,1,1
massimo,17.7929138053,5.80630293942,0,3,3
espparadox,17.7902916572,1.65667446699,11,33,44
ccm,17.7743729964,4.04447095348,1,6,7
trogdorbad,17.7690801914,4.87915617137,1,2,3
austntatious,17.7556521699,6.0643594541,0,2,2
nadamoor,17.7542094391,6.26619658776,0,2,2
aerodet,17.7445348629,6.37533311811,0,2,2
jello,17.735692478,3.25352006188,2,11,13
rillocks,17.7316936995,5.43231668607,0,4,4
frogge,17.7253633613,5.9122324286,0,2,2
charlie,17.7006913652,6.02158775086,0,2,2
tehz,17.6985538959,3.38688897158,2,8,10
liam_butler,17.6673384456,6.26628461383,0,2,2
matt47,17.6673384456,6.26628461383,0,2,2
colt,17.6613529856,6.33021997137,0,2,2
cochran,17.6461287722,4.65475524006,1,5,6
 ô·¥è·¥Ö·¥Ä·¥Ñ…™·¥è·¥ús,17.641713434,3.89772622793,1,6,7
maxi,17.6227902384,6.22931743478,0,2,2
general1712,17.6215829472,5.48333532544,0,4,4
whitegrizzly,17.6211632096,6.0044317998,0,2,2
jollie,17.6170690145,1.68809000791,11,34,45
pigwick,17.6145656845,5.7986697379,0,2,2
bozz,17.5664019227,6.1904438435,0,2,2
the drew,17.5298376391,2.44450078502,4,16,20
blank,17.5269841039,5.98245346039,0,2,2
ponkapa,17.5091493469,4.17271675114,1,8,9
rodan,17.49392076,5.80067000905,0,2,2
coolguy76,17.4938299885,3.4000538225,2,6,8
gambit,17.4724485757,6.03130753421,0,2,2
leet,17.4689467019,4.17774939693,1,6,7
maestro,17.466371113,6.23927752231,0,2,2
chinstrap,17.4649334833,4.56998857617,1,4,5
mechanicalmarine,17.4528876956,6.30697865609,0,2,2
sugaaku,17.4299431882,2.50415676215,5,14,19
catlover321,17.4213363947,4.2422915849,1,4,5
scraggus,17.420200668,6.18537395423,0,2,2
juan doe,17.3867926874,6.29163874819,0,2,2
capsui,17.3636773097,4.18172805452,1,7,8
chibaco,17.3366004938,2.73546540005,4,14,18
cennis91,17.31732748,3.6022560461,1,11,12
sad,17.3097710331,6.27674314988,0,2,2
lv20ninja,17.308817966,3.16185308662,3,7,10
hollow,17.3039925821,5.18130332859,0,3,3
beets,17.2985814968,5.63699083817,0,2,2
harmless,17.2905728248,6.22322606387,0,2,2
jonnjonn,17.2764189033,1.60230389626,11,37,48
luka,17.2764044926,3.67960459616,2,6,8
broonz,17.2688988629,2.01736770617,8,24,32
mntd,17.2462830625,3.52401762713,2,7,9
highlyeducational,17.2375645489,6.06569211323,0,2,2
spell,17.2029064941,3.41903494569,2,7,9
caprigon,17.1853311163,5.85795291687,0,4,4
ppdmd,17.1573329149,6.26923433457,0,2,2
scootieloo,17.1573329149,6.26923433457,0,2,2
holosly,17.1573329149,6.26923433457,0,2,2
iamlazee,17.1468785871,6.08466551875,0,2,2
sunkin,17.1467341997,6.24381075982,0,2,2
master j.j.,17.1358355436,6.24039459921,0,2,2
beech,17.1308483075,3.35694137191,1,12,13
luwolf,17.1067799133,6.23678452923,0,2,2
kraken,17.1055905081,6.27673109342,0,1,1
starcutter,17.1011463592,6.0665411989,0,2,2
driftintheabyss,17.1009098272,6.2415552758,0,2,2
amaya,17.0988004859,6.241919664,0,2,2
dinner,17.0933637711,6.08039702859,0,3,3
superflopp,17.0769831843,2.63649331016,3,9,12
eltrion,17.0678247458,5.90984228943,0,2,2
sam,17.0659865662,5.90317544352,0,2,2
mr_sharpie93,17.0643604398,6.22652518742,0,2,2
jgly,17.0573416651,4.24136323814,1,4,5
zarfon,17.0353081779,6.09705358847,0,2,2
ravioli,17.0284430048,6.30597887962,0,2,2
hotsauce,17.0178966432,2.93800791758,3,8,11
black rob,16.9946507075,6.21682728317,0,2,2
drlight,16.9870335546,5.93536565379,0,2,2
fj20,16.9789922863,2.18640441225,7,15,22
kastakatter,16.9667164161,5.6524740282,0,4,4
sianvar,16.9626890199,6.49709106715,0,1,1
giggitoxin,16.9572689606,6.19807969429,0,2,2
krutchby,16.9480969463,6.21319569398,0,2,2
pale,16.9461322307,3.43407236821,2,6,8
irish,16.9273178368,6.23983584333,0,2,2
rickter_scale,16.9273178368,6.23983584333,0,2,2
jazz,16.9273178368,6.23983584333,0,2,2
riseup93,16.9273178368,6.23983584333,0,2,2
waffles,16.9273178368,6.23983584333,0,2,2
d-tek,16.9273178368,6.23983584333,0,2,2
dd,16.9273178368,6.23983584333,0,2,2
umi,16.9273178368,6.23983584333,0,2,2
zurdo,16.9273178368,6.23983584333,0,2,2
digital cannon,16.9273178368,6.23983584333,0,2,2
miles,16.9273178368,6.23983584333,0,2,2
j,16.9273178368,6.23983584333,0,2,2
beekle,16.9273178368,6.23983584333,0,2,2
aubfox,16.9273178368,6.23983584333,0,2,2
sambook,16.9273178368,6.23983584333,0,2,2
grraffe,16.9273178368,6.23983584333,0,2,2
red,16.9273178368,6.23983584333,0,2,2
themickeynick,16.9273178368,6.23983584333,0,2,2
deku,16.9273178368,6.23983584333,0,2,2
paper tiger,16.9273178368,6.23983584333,0,2,2
azzy,16.9273178368,6.23983584333,0,2,2
sfgman,16.9273178368,6.23983584333,0,2,2
theycallmechris,16.9273178368,6.23983584333,0,2,2
uh what,16.9273178368,6.23983584333,0,2,2
raxcity,16.9273178368,6.23983584333,0,2,2
sunshine,16.9273178368,6.23983584333,0,2,2
zombieheart84,16.9273178368,6.23983584333,0,2,2
heisenberg,16.9273178368,6.23983584333,0,2,2
tuna,16.9273178368,6.23983584333,0,2,2
muthaluva777,16.9273178368,6.23983584333,0,2,2
dinkleberg,16.9273178368,6.23983584333,0,2,2
qk shkz,16.9273178368,6.23983584333,0,2,2
gaymer,16.9273178368,6.23983584333,0,2,2
abc,16.9273178368,6.23983584333,0,2,2
15(ichigo),16.9273178368,6.23983584333,0,2,2
draxsel,16.9273178368,6.23983584333,0,2,2
yuxminato,16.9273178368,6.23983584333,0,2,2
edwin...,16.9273178368,6.23983584333,0,2,2
searcher,16.9273178368,6.23983584333,0,2,2
shadow light master,16.9273178368,6.23983584333,0,2,2
mookie,16.913933823,6.19743545432,0,2,2
myroknpancakes,16.8849660659,3.33651208383,2,8,10
jojohnson,16.8847446083,5.91443560749,0,2,2
vidya_james,16.864470398,3.08809046365,3,8,11
bearrimshot,16.842472834,5.09567815586,0,3,3
dexter,16.8243851847,5.71776038407,0,3,3
bunnyblast,16.8164815237,6.1927063121,0,2,2
spammalanche,16.8051552964,5.8569187507,0,2,2
castaway,16.8048785331,6.06752345676,0,2,2
m2cain,16.8042217588,6.19615210708,0,2,2
comb,16.797825218,3.52359042482,2,7,9
louieg,16.7760314031,5.92876929973,0,2,2
killer,16.7708901809,4.84224642513,0,5,5
babycakes,16.7537887288,3.37083818826,2,6,8
halqery,16.7259513428,5.25211501368,0,4,4
vex kasrani,16.7238603154,3.46813373364,2,9,11
keychain,16.7199484044,3.82626725137,2,4,6
ceephax,16.7089307219,6.11810035735,0,2,2
saltking,16.6931775604,5.18033197709,0,4,4
mikeyg,16.6731347401,5.82364680069,0,2,2
jerzilla,16.6612408912,6.01798349036,0,2,2
jungle,16.6342906437,4.8319945118,0,7,7
rollock,16.6104007139,5.4215305657,0,3,3
diet clorox,16.6059205247,2.97743691286,3,7,10
falker,16.5988713559,3.30702938764,3,7,10
scott,16.5972710002,6.15290821858,0,2,2
atari,16.5595007381,2.47377637522,5,15,20
chibama,16.5491165808,4.23529826604,1,4,5
instacover,16.5173598147,6.03304199256,0,2,2
madara,16.513680413,5.27467026454,0,4,4
sabe,16.4819475971,3.23822162708,1,7,8
curiousplaces,16.4686400239,5.98022918707,0,2,2
lunarnova,16.4680065189,2.03328999856,6,32,38
jedipanda,16.4585589927,4.78425903047,0,5,5
superduperfanofboom,16.4490614314,6.13988079515,0,2,2
silentknight,16.4374794662,4.35954192203,1,6,7
bogmyer,16.4082927517,5.88014217953,0,3,3
dmolz,16.3996831443,4.95798281232,0,4,4
pc jeff,16.3765259588,5.97535171364,0,3,3
mattatari,16.3556222219,4.36768632966,1,5,6
nnaughtydogg,16.345061594,5.1208845319,0,4,4
magfmur,16.3354417012,5.811464978,0,2,2
nuggz,16.2594807788,3.60494045806,2,10,12
unknown presence,16.2511022045,3.20498269022,2,7,9
recneps,16.2163369397,4.28129220371,1,6,7
wilbur,16.1808061396,3.40579443152,2,6,8
thegoat,16.1133851124,6.05809160257,0,2,2
scruffy mcwonder crumpet,16.11288983,3.31848095173,3,7,10
duma,16.1127328596,3.63357480058,1,8,9
rocktimus crime,16.0877931289,4.77270442602,0,5,5
lord horatio,16.0420602558,5.55592870128,0,4,4
jedisalazar,16.0192355532,5.71533070597,0,2,2
i use tap jump,16.0165149658,3.71556058446,1,6,7
feathersruffled,16.013524172,3.62440955808,2,4,6
bill,16.0115521374,3.87079625809,1,6,7
bennypuff,15.9356868467,3.52744400244,2,7,9
mrkymrk,15.889861584,4.78445296877,0,5,5
dr-wumbo,15.8898561488,5.70788190605,0,2,2
redwolf,15.8831330222,5.97846405882,0,2,2
t-bone,15.8560293099,3.40402850079,2,6,8
noelkitten,15.8497628935,5.72052045472,0,2,2
12ties,15.8431344008,3.48275970376,1,5,6
eclipse,15.8423570806,5.16729776324,0,4,4
lampyshade,15.8201168229,5.42407608384,0,4,4
thedarkdreamer,15.802391653,6.01484204148,0,2,2
yolft,15.7990445872,2.41455948058,2,21,23
mixtape,15.7973649271,3.4844516738,2,5,7
codytappen,15.7829185268,5.6084782345,0,2,2
jackkenney,15.7486717643,5.85607149131,0,2,2
blahguy,15.7454563257,5.81008494948,0,2,2
don,15.7128643657,3.5582629368,2,5,7
turquoise,15.7044387477,3.26250408678,2,7,9
spaz,15.7023165563,4.19881499865,1,4,5
norwayray,15.6588448764,5.2483417756,0,2,2
dk dredd,15.6557600765,5.91918977555,0,2,2
vondo,15.6550556323,4.70163355769,0,5,5
mm720,15.6382508986,5.57974793217,0,4,4
twunt,15.6323772324,2.92286800221,2,13,15
kobra,15.6066340575,3.16112790685,2,11,13
crug,15.584857303,5.84565477559,0,3,3
atlas,15.5828538589,2.32565985537,5,17,22
uncle onion,15.5522960143,5.93876560258,0,2,2
aedrenaline,15.5125143786,5.74469940782,0,3,3
valyrym,15.4989919779,5.72015962435,0,3,3
banana,15.4989919779,5.72015962435,0,3,3
tydye,15.4962095478,5.71435404844,0,2,2
swankeaboo,15.4648382103,4.83763844412,0,6,6
bennyboy98,15.4372277588,5.95301151399,0,2,2
shimshamlando,15.3998206482,2.30707325557,4,28,32
fmaj7,15.3501840101,3.87814632509,1,6,7
mzadeh,15.3091728399,5.21530571426,0,4,4
peacemaker,15.2647702683,4.37866104995,0,6,6
vnko,15.2429758308,4.14267825008,1,4,5
lvl99wizard,15.2268739718,4.88670812349,0,4,4
tron,15.2087713296,5.60586040107,0,4,4
mariokartmoney,15.2023991933,5.46979181665,0,4,4
lou sanus,15.1991032062,4.53832160585,0,6,6
crestfallen,15.1651878329,2.93930141212,3,7,10
dude wut,15.1207690875,4.50873322478,1,4,5
bagel,15.1186791914,5.18939349256,0,4,4
thisisgettingold,15.115537955,5.93072884891,0,2,2
kezzup,15.1100225081,3.6205934363,1,8,9
tanuki,15.1054980142,5.76323790604,0,2,2
zbomber,15.0363471835,4.93404825129,0,4,4
warhorse,15.0229908205,3.76512542854,1,6,7
wiseacre,15.0018618858,3.59469136401,1,11,12
ir,14.98946052,3.8772172807,1,6,7
dyo,14.9803453145,3.54118410385,2,6,8
rumi1819,14.870631123,5.2413027485,0,4,4
captainpugh,14.8352116743,5.52534735664,0,4,4
bung0o,14.8343478852,5.15440892801,0,4,4
hufff,14.8224908002,3.6292319011,1,6,7
drunkn smash,14.8100059564,4.55262560714,0,5,5
katiebug (sfk),14.7089419784,5.57152979061,0,2,2
bchill,14.6916153136,3.21154497872,2,7,9
meccs,14.6904302729,5.01730950308,0,5,5
snoosnoo,14.666561739,4.23968104025,1,4,5
feartheday,14.596880048,2.88464317559,1,18,19
showtime,14.5885342399,5.8235225281,0,2,2
bear,14.5880854826,5.3170871848,0,4,4
cnasty613,14.5866297838,3.46825801551,2,6,8
midgetto,14.5189402358,2.31178096685,4,18,22
goofinhiemer,14.5164113384,4.9916556989,0,4,4
petty page,14.5048796459,3.27646125628,1,7,8
kevorkian,14.4966243709,2.81807647217,3,13,16
fmax,14.4895155373,5.50407742618,0,4,4
chacalaca88,14.4553249311,4.55860478977,0,6,6
marfthekid,14.4466348944,5.51340240222,0,4,4
willie,14.4150808525,3.76858348194,1,7,8
jp3,14.4114679607,2.90316683276,2,6,8
burmu,14.4082298553,5.35420278311,0,4,4
ferguz,14.3665774312,4.93350965091,0,6,6
hiddenmi$t,14.34367938,4.93356799161,0,4,4
armadillo,14.3370032885,4.55690388816,0,6,6
cag,14.3044644295,5.12704694426,0,4,4
ngwn,14.3014289894,3.41499501798,1,9,10
telemonic,14.2865739329,5.14461948259,0,4,4
sevshun,14.273307927,3.40165482603,1,9,10
dennysgrandslambreakfast,14.268260435,5.1546207116,0,4,4
ryden hope,14.2641936062,5.69595089582,0,2,2
yaks,14.2508683836,3.67388856106,1,8,9
boogie!,14.2127481569,3.29104997755,1,9,10
spaghetti,14.2116975738,3.01429403007,1,11,12
usvn,14.2071621096,3.36970121921,1,11,12
adam duncan,14.1952966149,3.28802275931,2,6,8
auggie,14.1884092316,4.08254946857,0,9,9
spazer,14.1365064132,3.11758231527,2,8,10
cgmontage,14.1272064482,4.14714605662,0,7,7
primefry,14.0640327937,3.06434157772,1,11,12
bluey,14.0057142216,3.06781435621,2,10,12
burglor,13.9872891528,5.36870827097,0,4,4
godofgrunts,13.9566092099,4.74742768861,0,7,7
hiv+,13.8834557719,3.41021628031,1,8,9
frapple_apple,13.8653544932,3.53990261675,1,7,8
myk,13.8626267077,5.36647171848,0,4,4
adamant,13.8244907836,5.26140974939,0,4,4
edgar allen pwn,13.7853873559,3.61008154017,1,10,11
road-rage 64,13.7833300194,4.50753159767,0,6,6
bort,13.7291892853,4.06366734154,0,6,6
heavy,13.7096027448,4.21795186777,0,5,5
rich,13.6988304488,4.94057076304,0,5,5
mf space,13.6687355317,4.72675447139,0,5,5
hashi,13.6668518477,2.42889943435,3,22,25
turtle,13.6581080809,4.39652834478,0,8,8
kronk!,13.6322416166,2.63560797984,2,18,20
scruff,13.603216098,4.97609549972,0,6,6
lotionhole,13.5974620728,4.42002027921,0,6,6
mike4real,13.58314091,3.33583723169,2,10,12
rhubarb,13.5370124534,2.90721000404,1,12,13
mattc,13.5116097545,4.30160948024,0,5,5
bluntsmokinganusdestroyer,13.4789863459,5.34889966099,0,4,4
whiz kid,13.4314625493,5.17021302234,0,4,4
ben,13.3399316792,2.54845820238,2,16,18
neff,13.2522296385,5.54211176444,0,3,3
mop,13.1810423784,3.27995598043,1,8,9
hwatts,13.1707260675,3.67154354338,0,13,13
gato,13.0775629675,4.41519769459,0,5,5
dabs?,13.0537698401,4.06876516381,0,9,9
greatwhitebuffalo,12.9999000539,4.66082584275,0,3,3
sour,12.9797452575,3.74868667933,0,10,10
oldiz,12.9653626635,5.08554212003,0,4,4
brother quang,12.9126342433,3.33296360784,2,8,10
weslec,12.8905446641,3.74782363426,0,8,8
lotus,12.8851344367,5.47531996401,0,2,2
monica,12.7983404328,4.57872454824,0,5,5
nardwell,12.7206445814,1.89572799787,6,45,51
zorro253,12.6956707563,3.2849670155,1,10,11
rokd,12.6643956494,4.62352292095,0,4,4
twisty,12.6488124155,2.57889257958,2,27,29
jofis,12.54093305,3.58196103364,1,7,8
phynque,12.4365730116,3.45113250603,0,12,12
tyler_stewart8,12.2826852589,3.60281071913,1,6,7
fabulousboy,12.2674255383,3.84157491934,0,9,9
terrible fate,12.2290973818,3.50849561393,1,12,13
lolitaz667,12.1771803714,3.33614014543,1,8,9
putpasswordhere,12.1076866113,4.50487538447,0,8,8
ohb-noa,12.0915858241,4.13486297313,0,8,8
doublej,12.0701183412,3.55650209025,0,13,13
neph_girl,12.0495363395,2.95619725017,1,14,15
jame,11.871389748,3.39056777212,1,10,11
sven,11.8284329492,2.64225818934,2,14,16
b rod,11.7908296072,5.01490236176,0,5,5
thundergarms,11.778103998,3.29613211901,1,7,8
syph,11.7188951868,3.63082173703,0,9,9
little things,11.6674821559,4.0062779826,0,7,7
mambo,11.6577805349,4.8247834233,0,4,4
nicklebackair,11.6039721368,3.50608470522,0,9,9
gasmask,11.5389797433,3.89090490725,0,8,8
whitezebra,11.4931570679,3.58320539405,0,10,10
microwaved hotdogs,11.4187957308,4.10238980467,0,10,10
baloo,11.4033071267,4.47227063923,0,5,5
half man,11.3706444874,3.67119471888,0,8,8
t3rquoise,11.2902942583,3.8285058703,0,10,10
ranger,11.2215599532,4.07099629518,0,10,10
stormcrow2,11.2160347427,3.45976389961,0,9,9
jet fuel,11.1354932977,3.16016458393,1,9,10
mello,11.0781626342,3.18893179483,1,16,17
reject,10.9906791945,2.51514577261,1,27,28
qwesseccssffdy,10.9459380725,4.94201488903,0,4,4
lloyd.,10.9111808953,3.65313911378,0,9,9
stevenballoons,10.8494421642,3.1421057934,1,9,10
jerry bean,10.7568069021,5.1819448958,0,2,2
elitescoringguy,10.6107523511,3.98227748805,0,9,9
2p,10.5230148765,3.30796570777,0,16,16
knothy,10.4944742264,3.62529124747,0,12,12
ceec,10.3556724725,3.39957467398,1,10,11
brizzles,10.2088353632,3.99535926266,0,8,8
copper,10.2012579706,3.75253296504,0,8,8
