player,mu,sigma,wins,losses,sets
hwats,9.89737526653,3.56134924487,0,12,12
yung duccboii,9.86213284747,3.96221571889,0,7,7
seaniemaster,9.64443257328,3.79773425367,0,8,8
macrado,9.53054638938,3.41251674407,0,13,13
gluu,9.49340390317,3.89166884512,0,6,6
jet fuel,9.32986638517,2.90082101732,1,16,17
soggy biscuit,9.18943961195,3.39952991469,0,9,9
seaweed dragon,8.98646221288,3.70423657157,0,8,8
golfclubninja,8.64952402787,2.81203128912,1,28,29
archduke,7.48789386018,3.60703309119,0,9,9
superboomfan,51.0810286483,1.18709247084,192,11,203
alvin,49.0492792431,1.20360059712,87,11,98
fukurou,48.7431381659,1.57786682516,42,4,46
mariguas,46.2081589258,1.10084944076,102,22,124
kysk,46.1620062592,2.04127762137,18,4,22
kurabba,46.0513147622,1.93225401366,20,4,24
wizzrobe,46.0487663528,1.08575060343,104,23,127
wario,46.0386049815,2.28872625603,18,3,21
wangera,45.3425530901,1.69763380865,29,7,36
kerokeroppi,45.1006951025,1.10619109605,83,23,106
dext3r,44.9949217327,1.15321631617,77,20,97
isai,44.688163874,1.26046265249,68,15,83
tacos,44.2037527809,1.1996445839,80,21,101
zero,44.0681336871,1.10930779345,92,22,114
fox,43.4716566899,1.29699717426,56,12,68
prince,43.4334250838,2.15430658016,17,4,21
joshi,42.6779641276,1.84781935173,21,5,26
tr3gthez,42.5698914901,1.2153888244,63,19,82
brody,42.5084643043,0.950726487219,185,57,242
lowww,42.2162209057,1.35001629768,53,11,64
gyaki,41.9528695672,2.64030643072,11,2,13
revan,41.9483665057,1.16375974401,65,22,87
yu-kun,41.6790960514,3.05228990998,5,2,7
hiyo,41.6080924621,2.69794320488,9,2,11
taimai,41.2131913957,2.99882201906,5,2,7
stranded,40.8456498877,1.21336765755,63,19,82
lord narwhal,40.1525904855,1.18216073334,60,20,80
robert,40.0062144981,1.31157218304,44,15,59
bloodpeach,39.9536359934,3.1970750121,9,2,11
dtan,39.8057737975,1.61279605002,24,10,34
jaimehr,39.7785405526,1.25775476863,48,21,69
firo,39.656929241,1.4610784722,35,14,49
cobr,39.5399545441,1.29725946636,45,18,63
hammerheart,39.1497164009,1.2604132681,55,18,73
kort,39.1414017154,1.73544106902,26,10,36
shalaka,38.9852594231,1.67031065598,27,11,38
derek #squats,38.8419594233,2.13064325542,11,5,16
sheermadness,38.6173040022,2.05070423479,16,6,22
czar,38.5777789228,1.6847453174,28,9,37
banze,38.5738127634,2.4543127245,11,5,16
hero pie,38.493475193,1.9679134067,18,8,26
heropie,38.4249290193,1.88050404928,20,7,27
ctg,38.4001672919,1.04205458657,90,34,124
kd3,38.377396656,1.05797074995,83,27,110
fireblaster,38.2282422025,0.938887073474,138,53,191
star king,38.1124837467,1.26409406173,50,20,70
nacl,38.0406309503,1.3515191295,43,18,61
handsometom,37.7394112942,2.02998436936,14,8,22
combo blaze,37.6431194441,1.45837789276,37,16,53
clubbadubba,37.6236333025,1.56987408777,30,12,42
kimimaru,37.6053578557,1.557423745,29,14,43
manjaro,37.5716470629,3.14363221245,8,3,11
bonobono,36.9965762617,3.29635424318,5,2,7
nta,36.7885985377,1.73361556356,23,10,33
janitor,36.7352804567,1.30434630904,51,21,72
janco,36.7121096178,1.73661638043,21,12,33
kyle tree,36.4692548214,1.91430351966,18,10,28
shears,36.4005960896,0.948151869934,137,60,197
marbles,36.2996807366,1.15779950282,56,24,80
loto,36.2602042745,1.24124020212,42,21,63
ybombb,36.2390681535,2.22528135013,12,8,20
greginator,36.1993629115,3.47288617915,4,2,6
stevie g,36.1578846394,1.37056504302,40,14,54
darkhorse,36.139211469,0.946557250712,101,52,153
skg,36.1219500434,1.27544618072,36,18,54
finio,36.0567683413,1.24308744113,44,21,65
nintendude,35.8152653656,1.19751995664,53,29,82
yunque,35.782944577,1.4683504081,31,15,46
horbie,35.5114219405,1.1657611928,61,29,90
roman,35.4516344638,1.51154640315,34,16,50
lorenzo,35.3268358858,1.65833206465,24,11,35
hydra,35.3034404863,1.70459259919,23,11,34
antwon420,35.0397966676,1.98758272939,15,7,22
nothing,35.0178450691,2.24135050833,14,6,20
fumbles,35.0006843912,2.14982578975,14,6,20
sotoh,34.8648956364,1.45944801486,33,19,52
purple circle,34.818942148,2.83839829103,12,4,16
blondekid,34.798698724,1.71763718662,22,11,33
jason,34.7973801408,1.63764348084,26,12,38
jose,34.7543979929,2.59110359189,8,4,12
amida,34.6764205455,2.26888997825,12,7,19
hotline,34.6192730007,1.66215576379,21,11,32
$$$ jim $$$,34.6127035684,1.44788811156,32,16,48
vinsanity,34.5841956497,1.87136194731,16,8,24
fray,34.4562563737,3.36066845428,3,3,6
letsgo,34.4069271936,1.82854958066,19,12,31
daniel,34.3528205816,1.62737406941,21,14,35
jam,34.337570351,2.58862509125,8,5,13
dark gentleman,34.3175598607,1.16769410131,50,26,76
supa,34.2905457814,1.60151696257,22,13,35
sax,34.0813644664,2.4105892947,10,5,15
gravyfingers,34.0758115653,2.04762978963,17,8,25
yobo,34.066923649,1.12695063348,54,32,86
connor,33.8866309277,1.93146242094,20,10,30
freean,33.8804836789,1.32223273228,37,21,58
eg,33.8700795375,1.47477021315,28,16,44
the ki of chaos,33.858323388,5.89151008587,1,0,1
james3927,33.6251527431,2.52524797704,11,4,15
madrush,33.582390313,1.02917849794,66,46,112
masterhandjob,33.5610379773,1.1118720774,54,30,84
wookiee,33.4973458052,1.3314610169,37,22,59
hipstur,33.4851830932,1.22289932904,51,25,76
b link,33.4210302855,3.4233122782,4,3,7
time machine,33.41284998,1.85157163627,19,10,29
pugs,33.3504406027,1.26102594578,35,24,59
schickler,33.3261125006,2.59122809914,9,4,13
butt solo,33.3123084348,3.84667442858,3,3,6
satan [turner],33.3043093714,3.29711714346,4,3,7
sextc,33.286136147,1.6276715764,21,16,37
fishaman p,33.2740791831,2.40097978322,9,6,15
raychu,33.2557313173,1.24393714054,47,22,69
dajjal,33.2383513958,1.71432564027,22,13,35
fruity,33.2334604019,3.52258587025,5,2,7
facechew,33.1235160338,3.94508944253,5,2,7
timemachine,33.0134012377,1.57469339411,25,16,41
sedda,33.0002882773,1.35531820323,36,20,56
near,32.9819887789,2.15945816319,12,8,20
zeppelin,32.9315705413,3.10089909277,5,3,8
smash jesus,32.8772466544,2.29388084063,14,6,20
monte,32.8766424428,1.92166162698,15,6,21
bo,32.8708984469,2.00069558251,14,9,23
indefa,32.851103485,1.93482026623,19,9,28
sunnyb,32.7879977522,3.56449745895,4,3,7
the protagonist,32.7678668701,1.1652887782,50,32,82
andykins,32.7012106587,1.536881508,25,13,38
mojomonkey,32.6571246739,2.20090075415,12,7,19
dr. grin,32.6441013537,1.88673852433,17,12,29
mr.sir,32.6241320832,1.11729889941,55,35,90
cyoonit,32.5905214092,1.87081527454,14,10,24
shihman,32.5643244678,1.30777410863,42,25,67
dogs_johnson,32.5586232896,1.2434140716,42,25,67
preston,32.5516552443,1.33895265686,38,22,60
nickelbackstreetboy,32.5484707936,3.54608000495,4,2,6
j.moosh,32.5364391158,2.80067343596,9,4,13
the big d,32.407643044,4.09802043876,4,2,6
poobearninja,32.4037778794,2.84303906931,9,4,13
stonefallow,32.392499565,3.49415537303,6,4,10
jay_mute$,32.3121467878,1.68378560537,20,12,32
dishier wand,32.2782455037,1.38858234144,31,23,54
th3kuzinator,32.2195835115,3.33454023191,6,4,10
subtle,32.1013926956,2.33354037464,13,9,22
gildo,32.0744469371,1.54798619878,27,14,41
the dark gentleman,32.0509317121,3.552146823,4,3,7
eggmode,31.9840503236,2.0984334227,13,11,24
b0n,31.9822767556,3.9641478883,4,2,6
jay-r,31.9593277163,1.52816841565,26,15,41
weedwack,31.9467036103,1.56875427375,21,17,38
knitephox,31.9450771041,2.41855201508,10,7,17
dogg,31.9213758108,2.58725412792,8,6,14
snorlax,31.9170574032,1.95250168505,15,10,25
ken,31.8110244458,5.40169263758,2,1,3
elel,31.7897813123,1.54054100212,28,18,46
spongy,31.7557916088,1.25597049224,39,22,61
bp,31.6602022594,2.20229440937,11,7,18
spark,31.6297182442,2.75594821915,7,4,11
qapples,31.6285185856,1.32846530791,32,26,58
tank,31.6104645255,2.48272508485,10,7,17
socrates,31.5954786099,2.51337648852,7,6,13
battlecow,31.5939869488,3.4016171486,4,3,7
bard,31.5485823666,1.27316735182,35,28,63
d35,31.5462243049,1.50195374897,26,18,44
nattybroh,31.5369189623,2.65377269796,9,4,13
kirbstomper,31.5188344006,3.86445858352,4,3,7
moosh_da_moosh,31.4940957431,2.09133592012,14,8,22
deathcpo,31.2498583458,1.24701441207,37,28,65
q!,31.2291120394,1.28818408406,38,28,66
dr. lampy,31.2211799079,1.62094987323,18,12,30
commander,31.219157037,4.42278572814,3,2,5
a to the z,31.2052346468,2.11350234695,11,10,21
josephzander,31.1977877538,3.43202608064,5,3,8
komotonoto,31.1486829374,2.27969098507,11,7,18
g0d,31.1403348642,4.50048660197,2,2,4
rossi,31.1312028168,4.20548682927,3,2,5
pete,31.0990824104,3.62685915722,4,3,7
saltsizzle,31.0756715634,1.73911576037,17,13,30
tyhiggz,31.0510752408,1.1844568567,43,30,73
studstill,30.9310670975,3.00777583832,7,4,11
kaz,30.9295167266,1.15704332965,51,31,82
ivor,30.8866197892,4.09947611008,3,2,5
jimmy joe,30.8631530819,1.08023925124,46,45,91
fck vwls,30.8197298565,2.26382559067,10,11,21
shanks,30.8108401106,2.93696326187,6,5,11
gunnermaniac,30.7898075966,1.97446564841,12,10,22
repsguy,30.7889690816,5.04031228625,1,1,2
miniohh!,30.7372553496,1.64719439455,20,13,33
paco,30.7321318088,1.32606670801,34,26,60
se√±orhen10r,30.7195440697,3.45201857995,4,3,7
tot,30.6935093983,3.09561865676,7,6,13
inukem,30.6870299912,3.45386431702,4,2,6
therm,30.657492689,3.99320286199,4,2,6
a$,30.6269116235,2.35940797574,10,6,16
limesoda,30.5850808737,1.65911506442,21,15,36
dubs,30.5848088535,3.18209149888,7,4,11
rusty,30.5613171084,1.22624057729,34,28,62
zeozen,30.5121863802,3.97389583729,4,3,7
jamjar,30.4926743582,1.08883756025,53,43,96
scoback,30.4572255462,2.44945699691,9,9,18
bowl,30.4325570516,1.64024489991,19,17,36
skyfire,30.4137229633,1.8279110428,14,12,26
joker,30.3962012023,4.03116250216,2,3,5
bread,30.3809815194,1.74097278677,17,15,32
natty,30.3716612042,2.7858708774,7,4,11
american patriot,30.3346624474,2.35095062089,8,5,13
korobeniki,30.1584750846,1.27592974014,38,28,66
the (.)(.),30.1306513894,2.39337013535,9,7,16
captain l,30.1247126916,1.89494442606,14,15,29
llcstoism,30.0842121859,1.73008940025,17,15,32
captain fabulous,30.0750293536,1.59655513474,23,18,41
pizza jokes,30.06111398,3.52302027129,3,3,6
emptyw,30.0431745549,2.67253566464,8,5,13
rith,30.0135657531,3.90958200199,3,3,6
yoleo,29.9590667712,1.93589410168,13,12,25
fancy,29.9518204603,4.24685236426,3,2,5
nyx,29.9419260485,3.21579052675,5,4,9
mokkori,29.9221620874,4.18659466566,3,2,5
onski,29.8803038251,1.49973903431,25,24,49
b33f,29.8692720513,1.35636615671,30,21,51
bt,29.856527014,2.17109114252,9,8,17
moogle,29.8328805413,4.33168728203,3,2,5
v,29.7876203612,1.37528840727,29,25,54
heny935,29.7663175994,3.94718579012,4,2,6
crockett,29.6797575789,2.44465412471,8,6,14
olbus,29.6740548915,3.96108120221,4,2,6
daniels,29.6685830572,1.47174055468,27,20,47
razz,29.6600385786,1.04376231311,61,46,107
spamus,29.6495440866,1.307028805,30,28,58
lob,29.6251452424,2.58462755566,7,5,12
mr. wang,29.6048887164,4.10245695982,4,2,6
reptar,29.571629091,1.29866801228,34,27,61
m-angry,29.5656554112,3.0836091634,6,4,10
bert,29.518071561,3.99480885129,4,3,7
pewpewu,29.5116742725,3.04412686807,8,5,13
wincancel,29.4774210059,2.66394573557,8,6,14
umbra,29.4752212703,3.27260665752,6,4,10
quitrage,29.4707454384,3.26089787172,5,4,9
newbtube,29.4418529564,2.73375585431,5,5,10
the american patriot,29.4373245494,4.21048447834,4,2,6
sheick,29.429273054,3.12414924558,6,5,11
piratetrips,29.4211027898,2.81001356653,7,4,11
rocket,29.420655359,1.33799957094,28,25,53
blue,29.39583202,7.17147558733,1,0,1
sarge,29.39583202,7.17147558733,1,0,1
charky,29.39583202,7.17147558733,1,0,1
dublat,29.39583202,7.17147558733,1,0,1
sampai,29.39583202,7.17147558733,1,0,1
stingers,29.39583202,7.17147558733,1,0,1
greeno,29.361249128,1.65833556538,23,15,38
annex,29.3329407914,1.80603902014,18,14,32
jxc,29.324541523,2.11440108967,11,8,19
logic,29.31958312,2.10019588145,10,8,18
thord's bro,29.3022808686,3.13299016763,5,4,9
0prah,29.2664321502,2.84989523656,6,6,12
t-beau,29.2636809431,2.79053728484,7,6,13
natendo,29.2608209536,2.06206593462,12,8,20
morino,29.2260895886,3.85461294267,3,3,6
reefybeefy,29.2140046246,1.83211058546,14,13,27
dizzle,29.1737477342,1.37443677422,26,27,53
bigfish,29.1476368465,2.72535299082,6,5,11
mustard tiger,29.0995072215,3.32198432043,6,4,10
aerosheep,29.0752383621,3.97125305516,4,3,7
nesskhalifa,29.0662289919,1.74954421338,16,16,32
toro,29.0095603006,4.38928209674,3,2,5
touque,28.9823537595,4.27259275633,3,2,5
kyle,28.9781565298,2.56575093164,8,6,14
chet dunskies,28.9727323589,3.43282227387,5,3,8
duffman,28.9576994666,4.44491789939,3,2,5
fil,28.9212671742,1.37250537606,26,28,54
gt,28.9206778147,0.921381328325,90,79,169
king lumsy,28.8944361407,2.65461708726,7,6,13
allgreen,28.8783830895,2.44337617154,7,6,13
yrn,28.8770146777,2.26079499729,8,8,16
broly,28.8374272901,4.38916703232,3,2,5
backes,28.8053643448,4.49134336743,2,3,5
elvis,28.7587498633,4.26553689379,3,2,5
pathall,28.7271970168,4.69344711303,2,2,4
bamster,28.6291770759,3.45965118853,5,4,9
a la carte,28.6131211007,3.55538815759,5,4,9
fenlet,28.5918514376,4.7412515528,2,2,4
kelvinheit,28.5820193805,1.43543058276,29,19,48
bon,28.5610273459,2.76799682546,7,8,15
breakthrough,28.55302744,1.94536297241,13,14,27
birdlordmasterbeak,28.5429251864,7.1211258753,1,0,1
zuko,28.4835695574,1.94174108162,16,14,30
cam,28.4621894809,1.97923159594,10,12,22
darkneon,28.4157960148,4.4070657674,3,2,5
epic!,28.4156833407,3.0167325123,6,4,10
purtle,28.40760031,1.96191645891,12,12,24
slappypoopy,28.372337013,1.59085794666,22,18,40
smurf,28.3233459858,1.26681738605,41,32,73
phut,28.3223415456,3.99197197983,3,3,6
tvdonk,28.3203937299,4.45958674045,3,2,5
ibc,28.3130419186,3.36281447405,4,4,8
coin chaser,28.2990279648,4.40912520839,3,2,5
tonester,28.2582063858,2.04970738784,14,10,24
fenrir,28.2529033434,4.6691782969,2,2,4
blaise,28.2055181803,4.52219949795,3,2,5
bloogo,28.2012381044,1.14644897879,39,37,76
peasantloaf,28.1958652619,4.26248928484,3,2,5
jsmirk,28.1872714709,1.51217942983,26,22,48
autobaun,28.1529055021,4.53845634446,3,2,5
bacorn,28.1436498056,2.47567422153,9,9,18
nattyb,28.1340321176,4.41412338,3,2,5
cody,28.1087830626,4.80396471385,3,2,5
toronto joe,28.0996945701,4.53051547838,3,2,5
batterybird,28.0646892936,4.53376969681,3,2,5
kraines,28.0154055579,4.8746850721,3,1,4
sebula4,27.9711233548,4.45140829467,3,2,5
mr. slimey,27.8861676951,4.73510882063,2,2,4
professor_wizard,27.8792182845,1.43548939249,29,22,51
box765,27.8643953122,1.38181676926,21,25,46
anotherish,27.8480172074,4.74511802982,3,2,5
enneielle,27.8195884603,3.84402021199,3,3,6
taiko,27.7901482209,2.48686928205,8,9,17
kriskringle,27.7832407555,2.88251230338,6,5,11
dragoniota,27.7660977373,4.48734501111,3,2,5
xor,27.7306959177,4.55622523955,3,2,5
automatic,27.7112317302,1.63851910053,16,19,35
zyrg,27.6875599983,3.14537362783,5,4,9
maliki,27.6866729341,2.07902890057,13,11,24
xyk,27.6764184763,4.4512066855,4,2,6
hack,27.6752340292,1.66480860703,19,17,36
waxy:joe,27.6677261683,1.34296831271,24,25,49
velocity jones,27.662380443,1.21634678906,34,34,68
rishi,27.6475622665,5.64875705304,2,2,4
kabal,27.625076721,3.87756274923,4,3,7
marlwolfe,27.552619447,3.82671112369,3,3,6
quickcav,27.55040182,3.25546867637,5,3,8
shake,27.5421507492,2.7502249078,6,7,13
t0mmii,27.5268971516,4.50511998972,3,2,5
duff man,27.4979817446,1.91974121519,12,14,26
maniac379,27.477165765,1.31615441703,31,33,64
viberant,27.4727167884,2.45493622978,8,7,15
r6=s2=(sr)2=1>,27.3962983928,3.74730572855,3,2,5
darv,27.3839540813,2.29649891735,9,10,19
my buddy mike,27.3630733325,5.18234526133,2,2,4
fake,27.3081604921,3.34909547495,4,4,8
toa,27.3056488335,5.4281468828,2,2,4
beans,27.293745045,1.70942549101,18,15,33
dpb,27.2936032517,4.60076381324,3,2,5
ern,27.2752491302,4.52152801546,3,2,5
1000,27.2336915033,5.26256748611,2,2,4
ringedge,27.1765206082,1.57539059561,20,16,36
p21/c,27.1544396025,1.87726571073,13,15,28
maze,27.1527115014,4.91674913149,2,2,4
dam_tewton,27.1088744412,2.32298570867,9,10,19
okuser,27.1050679999,2.21207465655,8,10,18
meromorph,27.0857756082,5.02208635203,2,2,4
pizza,27.0847540978,1.5198666781,23,25,48
freddy cougar,27.0208363255,5.4314485912,2,2,4
sunflower,26.9781834381,1.37943890257,25,28,53
jnatty,26.9494204028,3.09739635937,6,6,12
vudujin,26.9460054325,4.79897904172,2,2,4
the yid,26.8594608701,1.14857840761,42,45,87
mr.watchandlearn,26.8453200038,5.13273670901,2,2,4
cam2,26.8355822917,2.34244743503,7,8,15
vanddar,26.812335727,4.90847115312,2,2,4
big dick damage,26.7890955006,3.23204655221,4,4,8
cwic-beam,26.7675072582,1.92286687163,14,14,28
kaladin,26.7588062893,4.84757461904,2,2,4
flanders,26.732952644,2.7868617247,7,5,12
walkrofsky,26.7107924014,1.75979120588,12,17,29
maps,26.6848108511,1.50519155028,20,21,41
fudgeball,26.6801323654,4.1606982305,2,2,4
no~m,26.6775930439,2.79216018579,7,6,13
rizner,26.6688350036,1.92356206628,14,14,28
blue lantern,26.6383653265,4.9086615275,2,2,4
shyboy,26.6343030405,4.82060840724,2,2,4
sav,26.6098175521,2.34336295606,8,7,15
el man,26.5783091485,2.5966399111,7,5,12
hoofy,26.5782753239,1.59738597828,22,20,42
synth,26.5707186862,4.42243348254,2,2,4
salami,26.5641312556,3.05704908617,6,5,11
oh thomas,26.46012418,4.31017975649,3,3,6
dad,26.4549713653,2.89296583491,7,5,12
whitejesus,26.4334369089,1.2340104338,30,36,66
nalgas,26.4324148357,4.52154689818,3,2,5
mando,26.4297905715,2.17252396909,10,13,23
k rool,26.4098215916,1.76028553867,13,16,29
killahertz,26.3643937395,3.04031012948,5,6,11
gooby,26.3210313642,2.78018726629,6,7,13
stonehaus,26.3144683052,4.85649340991,3,2,5
thomdore,26.2874882903,5.07805052396,2,2,4
kirbyrocket,26.2712247238,4.29317764253,3,2,5
white,26.2127601873,4.45860810546,2,3,5
cam1,26.1917309117,2.51938523687,8,7,15
hhhhhhhhhhhhhhh,26.1805605948,4.94442759964,2,2,4
king funk,26.1614294024,4.11670584893,2,3,5
stew,26.1328433451,1.30337528514,32,34,66
hypa,26.1258403992,4.79492866376,2,2,4
droc,26.0830169111,1.36965322821,24,29,53
shishkabobs5,26.0718708003,5.37780397789,2,2,4
flatvi,26.0296454613,4.22497740251,3,3,6
toxic,25.967477776,1.89138722817,13,11,24
ham,25.9657830476,1.83752611071,13,16,29
boomalready1,25.9453830841,3.75152378119,3,4,7
bringdaruckus312,25.8961482234,4.91181907561,2,2,4
mortech,25.8623840594,1.6836023736,17,19,36
bigbeaver,25.8344290358,1.30521686096,26,34,60
collin,25.7972491334,2.28140498179,9,9,18
bunz,25.7840593762,2.19703374607,11,15,26
cmull,25.7646158657,3.4504720971,3,4,7
hoofydough,25.7113062928,4.91600928402,2,2,4
traiman,25.6867210152,1.96057835512,11,14,25
baby legs,25.6644977542,2.56296995681,7,7,14
lookalike,25.6377991163,3.68278876889,4,4,8
ace,25.6129118026,1.60193501652,16,21,37
webwipe,25.6092181606,3.38313777994,3,4,7
le_vinny,25.5997760684,3.31683109902,4,4,8
z-rex,25.5882656824,2.71034568239,5,8,13
blmb,25.5865551149,4.74730209217,2,2,4
sebula,25.5864414158,1.26451613051,29,35,64
meerkat,25.5830177788,2.38833218394,9,10,19
scratch,25.5733656836,1.86926899248,13,16,29
komodoninja,25.5686459495,2.70093913493,8,5,13
j9d2,25.5678331018,4.26488499498,2,2,4
tbq,25.5638398329,3.35544412538,4,4,8
chuck lubs,25.5606773425,5.02116683742,2,2,4
hariballz,25.5320289049,3.41696308649,4,4,8
prime,25.5214914717,1.67216178532,17,17,34
funkykong,25.5050742126,4.87107097566,2,2,4
slappymcnutz,25.4783125751,1.91530989592,10,16,26
ttt,25.4667600224,3.01270192511,3,6,9
justin,25.4567244722,2.694334942,7,6,13
mixxedvegetables,25.4501743805,4.70204997659,2,2,4
jlo,25.4120316069,4.81805105085,2,2,4
snowstorm,25.3934923152,4.93156978565,2,2,4
griffith,25.3680247179,1.38445469784,22,28,50
t brett,25.3671626614,3.85884397536,3,4,7
starchild,25.3611312572,2.95232769534,6,6,12
nasian,25.3404237394,5.74907458247,1,1,2
therapture_,25.3258278266,5.13054155253,2,2,4
salt,25.2941591503,4.96321040971,2,2,4
purple fox,25.2890644797,4.58709452422,2,2,4
sunvulcan,25.2870709646,1.54443418481,21,19,40
wazzberry,25.2821512309,4.73421942984,2,2,4
cortese187,25.2734327832,4.80713072026,2,2,4
swiftbass,25.2622368269,4.89216411198,2,2,4
h2o,25.2593669871,4.85995252983,2,2,4
zhu,25.2570917719,5.15198224649,1,2,3
klms,25.2540556461,4.9265753216,2,2,4
log,25.2510337499,2.95036435779,4,6,10
zbl_mystic,25.2424725068,5.22739906805,1,2,3
blisstex,25.2312491779,2.96012781862,6,7,13
pandemonium,25.220578387,4.55214797812,2,2,4
giraphe,25.1767537615,4.8547062007,2,2,4
wowzers,25.1586957156,4.68073409761,2,2,4
doughnut,25.1298367022,4.90231096598,2,2,4
qubit,25.1257493202,4.91426923128,2,2,4
karlthemarx,25.1124033326,4.8206721687,2,2,4
leavescat,25.0993709433,3.5385561854,4,4,8
poptartplug,25.0826285291,5.11818158289,2,2,4
iheartqueso,25.0797613885,2.64964574772,8,9,17
damp,25.0462356422,4.82420329543,2,2,4
notlightningrunner,25.0432425227,4.65308130371,2,2,4
tom bombadil,25.028091326,3.27564132604,4,5,9
measthebeast,25.0255168954,2.09152956735,9,10,19
beguiler,25.0181002617,5.04179208223,2,2,4
rudedude,25.0,8.33333333333,0,0,0
mojn,25.0,8.33333333333,0,0,0
jeremy,25.0,8.33333333333,0,0,0
moft,25.0,8.33333333333,0,0,0
mimi,25.0,8.33333333333,0,0,0
lunchy,25.0,8.33333333333,0,0,0
scuttlebug jamboree,25.0,8.33333333333,0,0,0
dunos_,25.0,8.33333333333,0,0,0
adubz,25.0,8.33333333333,0,0,0
sylveonbae,25.0,8.33333333333,0,0,0
thac0,25.0,8.33333333333,0,0,0
little bill,25.0,8.33333333333,0,0,0
snazzy,25.0,8.33333333333,0,0,0
masterofzoroark,25.0,8.33333333333,0,0,0
the amazing busterino,25.0,8.33333333333,0,0,0
bulldog,25.0,8.33333333333,0,0,0
k-phat,25.0,8.33333333333,0,0,0
sussebass,25.0,8.33333333333,0,0,0
hans_mawell,25.0,8.33333333333,0,0,0
mistertizye,25.0,8.33333333333,0,0,0
pilot,25.0,8.33333333333,0,0,0
chewy,25.0,8.33333333333,0,0,0
name,25.0,8.33333333333,0,0,0
sharktoast,25.0,8.33333333333,0,0,0
reb,25.0,8.33333333333,0,0,0
marfslayer 3000,25.0,8.33333333333,0,0,0
spicky,25.0,8.33333333333,0,0,0
oljace,25.0,8.33333333333,0,0,0
spade,25.0,8.33333333333,0,0,0
locamash,25.0,8.33333333333,0,0,0
levity,25.0,8.33333333333,0,0,0
l0n3r,25.0,8.33333333333,0,0,0
hypertj,25.0,8.33333333333,0,0,0
astumpyzombie,25.0,8.33333333333,0,0,0
goomah,25.0,8.33333333333,0,0,0
johnnyfight,25.0,8.33333333333,0,0,0
nikku,25.0,8.33333333333,0,0,0
shunkun,25.0,8.33333333333,0,0,0
sheen,25.0,8.33333333333,0,0,0
s≈çcrates,25.0,8.33333333333,0,0,0
ozymandias,25.0,8.33333333333,0,0,0
duckpimp,25.0,8.33333333333,0,0,0
paul d,25.0,8.33333333333,0,0,0
deep dimples,25.0,8.33333333333,0,0,0
vio,25.0,8.33333333333,0,0,0
bedgar,25.0,8.33333333333,0,0,0
jarl,25.0,8.33333333333,0,0,0
flash,25.0,8.33333333333,0,0,0
dr. light,25.0,8.33333333333,0,0,0
refriedjeans,25.0,8.33333333333,0,0,0
redribb0n,25.0,8.33333333333,0,0,0
branchan,25.0,8.33333333333,0,0,0
coldo,25.0,8.33333333333,0,0,0
madguy,25.0,8.33333333333,0,0,0
tweli,25.0,8.33333333333,0,0,0
bund,25.0,8.33333333333,0,0,0
ldz,25.0,8.33333333333,0,0,0
big d [hamiel],25.0,8.33333333333,0,0,0
awesomethesauce,25.0,8.33333333333,0,0,0
werewyatt,25.0,8.33333333333,0,0,0
aperture,25.0,8.33333333333,0,0,0
ferrero64,25.0,8.33333333333,0,0,0
redeagle2000,25.0,8.33333333333,0,0,0
esuma,25.0,8.33333333333,0,0,0
sd master,25.0,8.33333333333,0,0,0
dobermen?,25.0,8.33333333333,0,0,0
god,25.0,8.33333333333,0,0,0
xbc30ep450,25.0,8.33333333333,0,0,0
yung,25.0,8.33333333333,0,0,0
afro,25.0,8.33333333333,0,0,0
4eyez95,25.0,8.33333333333,0,0,0
smashlopez64,25.0,8.33333333333,0,0,0
urpasmash,25.0,8.33333333333,0,0,0
bird-dawg,25.0,8.33333333333,0,0,0
falln,25.0,8.33333333333,0,0,0
zane,25.0,8.33333333333,0,0,0
monk,25.0,8.33333333333,0,0,0
grunyan,25.0,8.33333333333,0,0,0
fireberts,25.0,8.33333333333,0,0,0
baedough07,25.0,8.33333333333,0,0,0
link,25.0,8.33333333333,0,0,0
astumpycow,25.0,8.33333333333,0,0,0
lukem,25.0,8.33333333333,0,0,0
dezno,25.0,8.33333333333,0,0,0
flat nat,25.0,8.33333333333,0,0,0
purplefox,25.0,8.33333333333,0,0,0
chai,25.0,8.33333333333,0,0,0
thomas,25.0,8.33333333333,0,0,0
brendanhall,25.0,8.33333333333,0,0,0
jobook,25.0,8.33333333333,0,0,0
fractal,25.0,8.33333333333,0,0,0
brentosfreshness,25.0,8.33333333333,0,0,0
tarn,25.0,8.33333333333,0,0,0
the cfb,25.0,8.33333333333,0,0,0
cr0ak,25.0,8.33333333333,0,0,0
mickeyrat,25.0,8.33333333333,0,0,0
rf!,25.0,8.33333333333,0,0,0
malkasaur,25.0,8.33333333333,0,0,0
emon,25.0,8.33333333333,0,0,0
king lui,25.0,8.33333333333,0,0,0
sabo,25.0,8.33333333333,0,0,0
squallette,25.0,8.33333333333,0,0,0
stephanie,25.0,8.33333333333,0,0,0
hail_sagan,25.0,8.33333333333,0,0,0
nokto,25.0,8.33333333333,0,0,0
dude,25.0,8.33333333333,0,0,0
sambo,25.0,8.33333333333,0,0,0
pvc,25.0,8.33333333333,0,0,0
spaff,25.0,8.33333333333,0,0,0
neverpullout,25.0,8.33333333333,0,0,0
magnus combosen,25.0,8.33333333333,0,0,0
sleeh,25.0,8.33333333333,0,0,0
magitech,25.0,8.33333333333,0,0,0
bronze_sun,25.0,8.33333333333,0,0,0
mouse,25.0,8.33333333333,0,0,0
foxnard,25.0,8.33333333333,0,0,0
electricgazelle,25.0,8.33333333333,0,0,0
pat,25.0,8.33333333333,0,0,0
karl,25.0,8.33333333333,0,0,0
[stg] overload,25.0,8.33333333333,0,0,0
bus,25.0,8.33333333333,0,0,0
birdybirds,25.0,8.33333333333,0,0,0
rice,25.0,8.33333333333,0,0,0
phex,25.0,8.33333333333,0,0,0
royeric,25.0,8.33333333333,0,0,0
puddn,25.0,8.33333333333,0,0,0
patty-wagon,25.0,8.33333333333,0,0,0
mahie,25.0,8.33333333333,0,0,0
core,25.0,8.33333333333,0,0,0
wolfcry,25.0,8.33333333333,0,0,0
price,25.0,8.33333333333,0,0,0
miken,25.0,8.33333333333,0,0,0
acestarthe3rd,25.0,8.33333333333,0,0,0
da bear,25.0,8.33333333333,0,0,0
pastor,25.0,8.33333333333,0,0,0
filet,25.0,8.33333333333,0,0,0
djltheescapade,25.0,8.33333333333,0,0,0
imperium,25.0,8.33333333333,0,0,0
hyperbole,25.0,8.33333333333,0,0,0
benb,25.0,8.33333333333,0,0,0
travkid,25.0,8.33333333333,0,0,0
voidstar,25.0,8.33333333333,0,0,0
juno,25.0,8.33333333333,0,0,0
k8,25.0,8.33333333333,0,0,0
tdx,25.0,8.33333333333,0,0,0
ubll black mage,25.0,8.33333333333,0,0,0
4sk,25.0,8.33333333333,0,0,0
tootmoses,24.9966615413,4.06941336739,3,4,7
sandman,24.9887255082,4.55877458215,3,2,5
village mascot,24.9728346558,2.21794551985,11,14,25
lou_sanus,24.9586878291,1.45712126042,21,24,45
imdabes,24.9544618082,4.9329171002,2,2,4
yass2queen,24.9521629583,5.55029356187,1,2,3
shaddi,24.9254026418,2.77544896139,6,6,12
dr.yonz,24.9156443293,3.02131890958,4,4,8
biz,24.9093322482,3.49494476884,3,4,7
jc_chill,24.8816904935,4.66007647926,2,2,4
hayrow,24.8760716524,5.60963176016,1,2,3
pintoa,24.8588465818,2.52168791314,8,9,17
olikus,24.8259621088,4.48978920791,2,3,5
dasit mane,24.8054783952,5.29757846679,1,2,3
pidgezero_one,24.8030371179,4.92260328023,2,2,4
7blanks,24.7857655914,4.03426846924,3,3,6
vanillarin,24.7809754632,3.89355343093,3,4,7
tafokints,24.7481474278,5.98106833786,1,1,2
yeye,24.7476627332,4.26757293005,2,4,6
schmerka berl,24.6935012931,2.51946631222,7,11,18
alex,24.6851948775,3.92126377247,3,5,8
daddy's milk,24.6676852937,4.12856222723,3,4,7
blueman,24.6572677844,4.14656578773,3,4,7
soulbroker,24.6490965711,4.77612071047,1,2,3
dankestdad,24.6437415848,3.67614204639,4,4,8
barron,24.6388741113,5.14153367566,2,2,4
tetsu0,24.6262993259,5.03796166079,2,2,4
handles,24.611959065,2.10961375661,10,11,21
dount,24.6060569127,4.09402006283,3,3,6
et,24.5999011581,1.87331096193,10,18,28
mmneggs,24.5976557766,3.37718265595,2,6,8
whuck,24.5828430357,4.01651529369,2,3,5
drinkwildturkey,24.5798499223,3.37922526385,4,4,8
thissidedown,24.5513665815,5.43925573599,1,2,3
tmakk,24.5249790204,3.24617068526,5,6,11
aces,24.5073475022,2.62233184478,6,11,17
fanboy,24.4889711,5.72519963919,1,2,3
cashhole,24.4774565353,5.40853349289,1,2,3
collin the conqueror,24.4582480014,5.06356359914,2,2,4
satch,24.4484190474,5.04404046701,2,2,4
dusttin,24.4402961589,2.20688569817,10,13,23
luigikid,24.3970096336,5.00145699011,2,2,4
jazzy jinx,24.3888989225,4.61063078292,2,2,4
pettanko-senpai,24.3808907771,2.65950624608,7,6,13
hotpocket,24.3795338043,2.48594927927,8,10,18
byff,24.3549127587,4.4266114949,2,2,4
chicken,24.3302488377,2.98041735151,5,7,12
tauvalian,24.3283622006,5.04985079081,2,2,4
reese,24.3021092979,4.43609296046,2,2,4
sombrero,24.2179958312,5.24435673891,1,2,3
esid,24.2105365312,2.14209567747,10,9,19
monkey,24.1990733521,2.0388701782,10,13,23
gamer4life,24.1936988112,4.62671965627,2,2,4
chevrium,24.1816476578,3.68855871442,3,4,7
enemajoe,24.176067015,3.24370017169,4,4,8
moist,24.1742036403,4.99802031958,2,2,4
smashg0d,24.1473408161,5.37571815839,1,2,3
k-nut,24.1365368992,4.29427694186,2,3,5
skrull,24.0382413029,4.94514045373,2,3,5
drewgong,24.0358916571,1.78480039469,13,16,29
gaggleforce,24.0194562669,5.21379339102,1,2,3
dsj,24.0192011089,2.66948945365,6,6,12
sunshinetk,23.9911996257,4.72938122836,2,3,5
pzero39,23.9815324768,2.11688999186,10,15,25
jinjo,23.9700897429,5.5704973186,1,2,3
natural brother,23.961096564,2.89829088903,5,8,13
kevine,23.9477325873,5.60074788092,1,2,3
costaricancool,23.9301440452,4.56037777054,2,3,5
slippypickle,23.9142962539,4.27312327083,2,4,6
nuggzy,23.9133660777,4.78267472168,2,2,4
savior,23.903488871,4.95466006915,2,2,4
ders,23.8772308793,3.70656914992,5,4,9
wubbs,23.87607831,4.93139316664,2,4,6
jaquarium,23.8404794066,5.04087719999,2,2,4
camerino,23.8308943762,4.17625338551,2,4,6
khakis,23.8195168002,4.66275126303,2,3,5
dirtcruncher,23.8081199349,3.34521926927,4,6,10
waldo,23.7825553119,4.19578685754,2,3,5
monad,23.7689689056,1.50644780643,17,31,48
cmac,23.7547264055,3.29601258295,4,6,10
grahamaglam,23.7514956255,1.9865251709,8,14,22
gaijilla,23.7335000994,5.89458141807,1,2,3
mr. biz,23.7210641953,5.05089869586,2,2,4
probers,23.6839741158,4.62700656,2,2,4
truffleshuffle,23.6788769285,4.52693030002,2,3,5
zenaga,23.6761009151,5.50042648943,1,2,3
icho,23.6501151844,4.88088743887,2,2,4
sk,23.6277182032,5.64533312994,1,2,3
majin_bukkake,23.6139469116,1.94749692579,11,16,27
papaghanoush,23.5978255213,3.54319895291,3,4,7
puncayshun,23.5919013814,3.55840543127,4,3,7
wheels,23.5681347817,2.18415757257,8,7,15
searing scar,23.5676545723,4.41065096171,2,4,6
izoo,23.5371695413,5.42181231484,1,2,3
wal,23.5336824981,5.76636514869,1,2,3
capos,23.5253868086,1.11886721219,43,54,97
b.i.,23.5200501309,1.95755630234,9,13,22
file,23.4930135044,2.60314725938,8,5,13
kingkool,23.4857207168,2.48850692837,8,10,18
arctic,23.4684294881,5.40148296815,1,2,3
bre,23.4497317322,2.34380399817,7,9,16
chronicmexican,23.4460605719,2.44995578927,6,12,18
derstuk,23.4427797579,2.16554060051,10,12,22
staysleepin,23.423059197,2.92012735893,4,8,12
sonicfuzz,23.4068986885,2.0278804774,12,15,27
moze,23.381054954,4.99312119924,1,2,3
pochilin,23.3686415636,3.89578154083,3,5,8
rawdog,23.363334365,5.06369679768,2,2,4
steamfriedasian,23.3621246951,5.73391255533,1,2,3
-philip coast philip-,23.3460507534,5.25167639573,1,2,3
thrillhouse,23.3109346336,1.83361757628,11,17,28
gera,23.2851911871,5.48739664317,1,2,3
sph,23.27614359,4.5186933381,2,3,5
bhol,23.2195434706,2.26458733734,8,11,19
neth,23.1861020266,5.49320539377,1,2,3
qtip,23.1471201424,5.96320374501,1,1,2
dwreck,23.1427050378,5.50870913819,1,2,3
chino san,23.0976720192,5.41410597652,1,3,4
clefairy as mew,23.0927379524,4.95371121424,2,2,4
bottle opener guy,23.0623334097,3.3632243122,4,4,8
weedlypuff,23.0532063713,3.21345087076,4,5,9
andy,23.0499640124,3.15747758081,3,6,9
masquerade,23.0480593414,5.50126583567,1,2,3
minymidge,23.0439647415,2.16273975594,7,16,23
ardent rage,23.0390518825,5.33053236201,1,2,3
matt,23.0386923421,3.23615703886,3,5,8
bimbo,23.0253382493,2.95005127526,4,5,9
dex,23.011135291,7.26144247377,0,1,1
garv,23.0093845888,3.94328771045,2,2,4
gibbles,23.0004859097,4.98564418899,1,2,3
jaapoh,22.9978698942,3.61369664983,3,4,7
kman,22.9932321123,5.67901093998,1,2,3
billbacon420,22.9582179558,1.42944461654,20,31,51
ditto,22.9278085324,2.34268172349,7,11,18
ajbcdefg,22.9252718744,1.44055491827,22,29,51
pluto,22.9092643073,5.56218526537,1,2,3
asaaj,22.8778868697,3.29585708146,4,4,8
bean,22.8612391368,1.75300628727,12,25,37
nigel_thornberry,22.8525552656,5.24517339621,1,2,3
brny,22.835010313,5.26675091251,1,2,3
zibba,22.8170969194,7.24300767435,0,1,1
lordtoko,22.8145922827,2.74909805192,5,7,12
dankpank,22.7918043915,1.36538338158,23,33,56
duncs,22.7649335986,1.56895800889,20,24,44
bflakes,22.7547403217,1.92294873679,11,16,27
greenblob,22.752595344,2.93477757711,4,7,11
dsyr,22.7488958314,4.00160940267,2,2,4
bodacious,22.7456335897,4.10770698892,3,4,7
xanz,22.7216903438,5.09008313622,1,2,3
bonerstorm,22.7131543348,5.03759629022,1,2,3
goosewithsocks,22.7048242186,1.56368420829,18,23,41
silver,22.704181545,3.14963276874,4,6,10
verwaltung,22.6867102224,5.67101579923,1,2,3
egg,22.6848235263,7.13555646269,0,1,1
drewskii55,22.6773296708,7.1998936357,0,1,1
crazyk115,22.675195546,5.13123091144,1,3,4
rgood,22.6568814078,5.22740397957,1,2,3
xif,22.6514029781,7.12491104683,0,1,1
aisengobay,22.6281627487,5.02165362371,1,2,3
boh,22.6263883891,5.22409885802,1,2,3
nanagens,22.6186462603,2.84165764132,7,5,12
cooljoe,22.6161343304,5.22917378086,1,2,3
foda,22.6008895618,1.94827719458,11,14,25
cyan can,22.5942471255,3.56957602676,3,6,9
hotahota,22.5721702477,2.7389474383,7,7,14
cuppajoe,22.5614711416,3.98912966001,3,4,7
evals,22.5497261156,5.26109394584,1,2,3
zhao_guang,22.5365888891,5.28248014937,1,2,3
robnu,22.5361970475,5.27291984814,1,3,4
schlag,22.5295736344,5.64093463869,1,2,3
stylisland,22.5090345892,4.90400237762,1,2,3
keagsbsmashin,22.505682607,4.93161471885,2,2,4
lldl,22.4754387364,5.54602983821,1,2,3
momdameatloaf,22.4568844776,2.75677791208,5,6,11
bohemian milk,22.4410234019,5.64191828862,1,2,3
mourin,22.436189438,5.53322447519,1,2,3
rythemretrn,22.4257927027,5.54390698698,1,2,3
okay,22.4197817672,5.79928764272,1,3,4
leaf fc,22.4109891495,3.30065233849,4,6,10
bombproof,22.3655202386,3.1275042393,4,7,11
hsf,22.3577182729,5.21749074515,1,2,3
widdy,22.3499227064,1.77357263855,14,27,41
tokaji,22.3418384892,5.72549549374,1,2,3
the professor,22.3357851457,3.93517245049,3,5,8
zergos,22.3298962465,3.28070990344,4,6,10
panda,22.3248062829,2.87002155517,5,9,14
maaron,22.3235126558,5.2279102694,1,2,3
rebel scum,22.3120968499,3.35281578104,3,5,8
milleneum,22.2991635697,2.66428346069,5,10,15
yakal,22.2950630033,5.45881954507,1,2,3
green eggs and spam,22.2655382866,3.9744350034,2,4,6
sun vulcan,22.2630109463,3.9758599453,2,4,6
happens,22.2580974684,3.37943157571,3,5,8
adrian,22.2449221962,5.4939042246,1,2,3
geekliftus,22.2334848055,5.51993490319,1,2,3
train_town,22.2182491195,5.25970810876,1,2,3
moonshoe,22.2104897039,1.22652531302,30,49,79
squible,22.2048569565,2.73948101316,6,7,13
hunter,22.192348914,2.20621797061,7,11,18
prism,22.1846826736,5.77103200607,1,2,3
ocelot,22.1825902216,2.14126439037,6,17,23
grrg,22.1691868557,2.56900141279,6,11,17
toez,22.1553647895,5.17920931727,1,2,3
mickeyo64,22.1550461695,5.04687080485,1,3,4
cbones,22.1425979996,5.17784168517,1,2,3
chiefreaper,22.1151859141,5.33476205532,1,2,3
omar,22.0850847713,4.52884736638,2,4,6
giraffe,22.0832446758,5.52720444839,1,2,3
mr. tit,22.0572335245,2.53904455263,5,7,12
mrryanness,22.039784547,3.7285886753,3,7,10
hotspank,22.0341544567,2.5367787926,6,12,18
hamburglar,22.0313772247,5.47262274073,1,2,3
hbrw-hammer,21.989450955,5.19683618143,1,2,3
mrpoo,21.9694395301,5.5090539933,1,2,3
banana fiend,21.9571408911,5.00477127102,1,2,3
zarc,21.9523180178,5.3661603852,1,2,3
han,21.8966597569,5.31977588561,1,2,3
kzidek,21.8867795024,5.53430238446,1,2,3
papasquat,21.8594823624,1.62579867145,12,27,39
sebson,21.769514896,4.86815673987,1,3,4
kristoff,21.7529910726,1.91146566922,12,19,31
kaddy,21.7448383797,6.97871477739,0,1,1
pizzajokes,21.7162054905,5.50815225737,1,2,3
paco [larkin],21.7159475813,5.45508770932,1,2,3
burnt out ninja,21.6867950646,5.49425252058,1,2,3
fawnco,21.6867950646,5.49425252058,1,2,3
keatsta,21.6811557564,5.27318778728,1,2,3
cardoso,21.6780577038,5.47180539926,1,2,3
eggmcmuffin888,21.6448289632,2.48402826281,5,9,14
gumbolaya!,21.6434793433,5.28700972786,1,2,3
iceking,21.6312087957,2.74842302339,5,12,17
elated,21.6290219575,2.05961598664,9,16,25
dax$,21.605782322,2.65618841047,6,6,12
halffulla,21.5882240248,3.47885514546,3,5,8
moonlight,21.582972799,2.70274423212,4,9,13
calzum,21.5715521788,5.33711999753,1,3,4
yolochi,21.5679741858,2.38997371764,7,13,20
slartibartfast42,21.5328392932,4.28071789839,2,4,6
macintosh,21.5310980937,3.43767522779,3,6,9
evab,21.5281310611,5.45654170068,1,2,3
ondas,21.5111827075,3.48818106101,3,5,8
anathema,21.5047657545,5.52858492613,1,2,3
kossismoss,21.5047657545,5.52858492613,1,2,3
jirachinick,21.5047657545,5.52858492613,1,2,3
zwephy,21.5047657545,5.52858492613,1,2,3
zombie!,21.5047657545,5.52858492613,1,2,3
trevman,21.5027061159,5.10402665286,1,2,3
weirdy man,21.4938394777,5.32664823819,1,2,3
xiivi,21.4876272424,2.85828017362,5,9,14
sadu,21.4831253742,5.56869670732,1,2,3
tipc,21.4629393916,2.90551794916,4,8,12
tubby!,21.4564380732,4.56539704494,1,4,5
jmabate,21.4375021927,5.28753891929,1,2,3
fearlesscaboos,21.4285257127,5.32500494842,1,2,3
gray,21.4074828323,2.6621399826,5,8,13
v-bomber,21.4000216092,4.19284654502,2,4,6
elrond,21.3733825878,2.44955341385,6,13,19
napkins,21.3422581477,5.51129103904,1,2,3
whoopiecow,21.3422581477,5.51129103904,1,2,3
bubby,21.3396390978,5.35310713357,1,2,3
moustasher,21.3240850639,2.42939828215,7,12,19
boink,21.3209697029,3.3366000317,4,5,9
fish,21.2725190516,7.11048197228,0,1,1
pikasneeze,21.2573339064,2.75272917221,5,6,11
frostbyte,21.2357055857,3.47834663738,3,7,10
minusev,21.228864937,7.0978953209,0,1,1
peaceful soujourner,21.1912761626,5.11430055233,1,2,3
jdp,21.1698744691,5.11548379486,1,2,3
blue bear,21.1002964099,5.55587524657,1,2,3
shasta,21.070209472,5.51002169606,1,2,3
kavon,21.070209472,5.51002169606,1,2,3
hungrybox,21.0458327936,4.48872068442,2,4,6
fingerblast,21.0282940861,4.56717238675,2,2,4
static,21.0244630813,3.565238039,3,5,8
mizbiz,21.0238512604,3.26557885487,4,4,8
kosher,20.9821790496,3.11616860553,3,6,9
catastrophe,20.9632170758,3.69991633513,3,4,7
doby,20.9525156082,4.83932081825,1,2,3
h00n,20.937641587,3.73991551124,2,4,6
dair,20.9310917539,3.28112725247,4,4,8
zerobombjake,20.9019435546,3.22939106405,4,6,10
fuzzyness,20.8785228451,5.24584273634,1,3,4
dr combos,20.8771243056,3.28219740049,2,8,10
tallboi,20.8696895355,6.62147044785,0,1,1
java boy,20.8573962319,5.51420898734,1,2,3
yungpurp,20.8494147883,6.68210388938,0,1,1
apparition the ambassador,20.8444734867,1.20517782772,25,55,80
seantos,20.8439633986,1.94271186456,11,23,34
big tone,20.8406120534,7.05844745916,0,1,1
lucky_hamburger,20.8263796171,2.95304557852,4,7,11
ttp,20.8079131366,3.45116651,3,6,9
zad,20.8037023428,3.38007051069,3,7,10
eliot,20.800150921,4.9216372622,1,5,6
dankey kang,20.7970110754,2.15352298972,7,17,24
fork?,20.7898010183,4.94817661835,1,3,4
zach777,20.7767923152,6.4516699852,0,2,2
buttery adachi,20.7687609294,4.64424719392,1,3,4
mojo,20.7589379883,5.1984974191,1,2,3
lalo,20.7423750734,4.13893185685,2,4,6
joel,20.6845514615,2.78180438609,5,8,13
zouzy,20.6755344261,5.54532760265,1,2,3
hipo,20.6704005576,5.21848248582,1,2,3
brotherly,20.640068758,2.75378871533,4,7,11
benbook,20.60416798,7.17147558733,0,1,1
uprowr,20.60416798,7.17147558733,0,1,1
penance,20.60416798,7.17147558733,0,1,1
changed man,20.60416798,7.17147558733,0,1,1
k-man,20.60416798,7.17147558733,0,1,1
sherb,20.60416798,7.17147558733,0,1,1
phalanx,20.60416798,7.17147558733,0,1,1
lonk,20.60416798,7.17147558733,0,1,1
josiab,20.60416798,7.17147558733,0,1,1
bunmira,20.60416798,7.17147558733,0,1,1
silent skyler,20.60416798,7.17147558733,0,1,1
drewjames,20.60416798,7.17147558733,0,1,1
sfat,20.60416798,7.17147558733,0,1,1
fs shampoomaster,20.60416798,7.17147558733,0,1,1
thissideup,20.60416798,7.17147558733,0,1,1
kayo,20.60416798,7.17147558733,0,1,1
nfreak,20.60416798,7.17147558733,0,1,1
5000candlesinthewind,20.60416798,7.17147558733,0,1,1
nyani,20.60416798,7.17147558733,0,1,1
ragingcherry,20.60416798,7.17147558733,0,1,1
akajumo,20.60416798,7.17147558733,0,1,1
4 phri,20.60416798,7.17147558733,0,1,1
jad,20.60416798,7.17147558733,0,1,1
mystery,20.60416798,7.17147558733,0,1,1
nannose,20.60416798,7.17147558733,0,1,1
yung god,20.60416798,7.17147558733,0,1,1
captain murphy,20.60416798,7.17147558733,0,1,1
akito555,20.60416798,7.17147558733,0,1,1
queso,20.5976543545,2.82476201482,3,8,11
jaws,20.5676658066,5.35482917924,1,2,3
nuro,20.5389518189,5.43185785249,1,2,3
goose,20.5387724259,3.84691662953,2,4,6
icactusdog,20.5312062943,1.16514071529,31,76,107
flatline,20.5164882806,5.24452888369,1,2,3
thenuge,20.5013392426,5.04003806029,1,3,4
three beers,20.4490360428,2.69576917466,4,8,12
heartsdealer,20.4405992168,4.22373191901,2,4,6
voff3,20.3954522573,6.99340631441,0,2,2
throwz?!,20.3712942976,5.17095113297,1,2,3
barrels,20.3686059834,3.85809326249,2,6,8
homemadewaffles,20.3612733202,6.92690169084,0,1,1
cormander,20.3427502889,2.70324590565,4,12,16
mr baninawi,20.3193599258,4.50670802383,1,2,3
e-jager,20.3123156978,4.96781224838,1,3,4
hero,20.3003305973,6.88831159169,0,1,1
spunker,20.2783887162,6.64193201717,0,2,2
acerunner,20.2746344695,3.82934841574,2,5,7
caelan,20.204195046,7.0610632401,0,1,1
mighty afro dighty,20.1755061532,3.72530133458,2,4,6
papa,20.1731212911,3.04976199728,4,8,12
butcher of bakersfield,20.1709924669,3.98886789201,2,5,7
jag,20.1687674835,3.03004583692,4,8,12
mikeyp,20.155369062,2.64394932075,5,10,15
fritz wethermyb,20.1288268707,6.19803116188,0,2,2
mjim,20.1233884446,2.69985350792,4,12,16
teflon ron,20.1044183671,3.33073885739,2,6,8
izze,20.0863911483,4.69116917934,1,4,5
bawdbabe87,20.0498430187,2.97325476368,5,8,13
aegeze,20.0497954035,3.37833596155,3,5,8
howdy,20.034008369,2.07216150964,11,16,27
nich,20.0240191268,3.24542030594,3,10,13
shug,20.0183053624,3.29331752635,3,8,11
accru fenix,20.0033415701,2.89631748442,3,10,13
b vu,19.9779918419,6.56462785713,0,1,1
depressed eagle,19.9668557046,4.71517261952,1,3,4
weatherman,19.9361842857,6.05438025427,0,3,3
tallyshell,19.9342139881,5.03744670312,1,2,3
takuto,19.9228222913,3.46626980674,3,4,7
kiwi,19.9097718712,3.21178034094,2,7,9
stark,19.905813676,2.12720300838,7,15,22
pokmo,19.8840826827,2.97814128016,3,8,11
maximum can,19.8807968822,6.1968182466,0,2,2
pika,19.8665160974,4.50476058035,1,4,5
frogman [charette],19.8470685379,6.53515646093,0,2,2
nineball,19.8348885377,3.00539705828,3,7,10
danny,19.8132004678,6.8317061207,0,1,1
king robin,19.8128673226,5.18519924189,1,3,4
spt,19.8025232552,6.38548140082,0,2,2
dad's musical erasers,19.7703658544,6.34330364497,0,2,2
multiball,19.7642357762,2.18482493849,8,16,24
mikelangelo,19.7461948385,6.43727618769,0,2,2
cagt,19.7224217511,1.62668162982,16,27,43
sebastian,19.6269328229,2.92115741082,4,8,12
rogue1wasjustok,19.5926999385,2.87894508476,3,8,11
muse,19.5613502729,2.17102029738,8,14,22
fiasko,19.495661402,4.8063268,1,3,4
yaron,19.457187768,3.69052851875,1,6,7
danno,19.4480883685,5.26348120732,1,2,3
dimension,19.4061385287,6.20651346822,0,2,2
qerbstomp,19.380845552,3.20995079398,3,10,13
diveo,19.3698916944,2.23107873274,6,18,24
tangerine,19.3611697463,2.75986733355,5,10,15
fred,19.3512733707,4.82054371145,1,4,5
fumofuu,19.3003820949,6.70094005858,0,1,1
veen,19.2649590252,6.50769593739,0,1,1
magic,19.2537975509,3.12621082347,3,5,8
houndour,19.2327258766,4.73131642357,1,5,6
missingn0,19.1950717181,6.10648839204,0,2,2
russellsprouts,19.1765865947,1.27388573722,24,69,93
rush,19.1742263808,2.88137426691,3,9,12
jive turkey,19.1625087071,4.30374918238,1,4,5
krypto,19.1590647171,4.80958059903,1,4,5
bluebear,19.1530363979,2.68131910476,5,10,15
husker,19.1404494768,4.23587159018,1,5,6
laugh,19.114713734,2.80678283472,4,10,14
bleachfanboy4life,19.0732656456,5.04665108656,1,3,4
brown_omega253,19.0495734057,6.32975483504,0,2,2
k,19.0428343177,5.95249011755,0,2,2
slatts,19.0152410546,1.76484434788,10,27,37
supernuggit,19.0044071256,2.47455245629,5,12,17
esmod,19.004211349,6.50799591405,0,2,2
skubtard,19.0028728103,6.87267909617,0,1,1
fs mook,19.0028728103,6.87267909617,0,1,1
jiffypop23,18.9770135252,3.36016302515,3,6,9
rabizkoshik,18.9387563269,4.96521521123,1,4,5
kingcool,18.9351088349,3.64474619053,2,6,8
guccipivotmaster4000,18.9347382351,6.43705129894,0,2,2
ensindic,18.9269660779,2.81993623622,4,11,15
ego,18.9220364506,6.43080985891,0,2,2
dixoncider,18.9213932644,2.98178490355,4,9,13
precookedbread,18.9052180392,6.13144583345,0,2,2
engdrew,18.8748821964,2.71471489824,3,9,12
dcmaster,18.8722048693,3.30903151487,3,6,9
luwolf,18.8484820941,6.29597085244,0,2,2
quentendo,18.8269386238,6.15804464037,0,3,3
muthalova7,18.805754164,3.29811846942,4,5,9
neat,18.7972635128,2.45441178367,4,17,21
blizz,18.7928519856,6.79635578797,0,1,1
turtlpower,18.7895018776,6.35251859374,0,2,2
littlespoon,18.7797815395,6.3597378531,0,2,2
bananabolts,18.7791074114,4.13204943699,1,5,6
mr.e [rohr],18.7703709704,6.52341434227,0,2,2
flare,18.7465155821,4.81875856505,1,4,5
iacme,18.7005700184,5.87207445275,0,2,2
duck chris,18.6843486974,6.48895532793,0,2,2
fen,18.6651960945,4.60992013254,1,4,5
wilbur,18.6626543115,6.48074959922,0,2,2
jgin,18.6321608332,5.92034936976,0,2,2
kieuarty,18.611156125,6.46321841715,0,2,2
youtwo,18.6056078068,6.49184921396,0,2,2
r.o.m.,18.5588529466,6.38820575423,0,2,2
kl3an,18.5588529466,6.38820575423,0,2,2
pokeiman_master,18.5516219727,6.44406310517,0,2,2
crazy_cubano,18.5382499757,3.26108931537,3,6,9
nathansandwich,18.5325726119,3.36780051615,3,7,10
tdp,18.5322048421,6.27670782881,0,2,2
lecceo,18.5224563478,6.04122538682,0,2,2
failcant,18.5036619979,6.53954925511,0,1,1
ltdan,18.4783986516,4.30005924687,1,4,5
tbone,18.4739919389,6.26372813517,0,2,2
nagurnimaster,18.4700890997,6.22509745584,0,2,2
superkirby,18.4611593024,6.07126152759,0,2,2
ender,18.4548138371,3.086263985,5,6,11
pugdaddyfre$hlyfeogg*flva,18.4491791431,6.2655689814,0,2,2
reno,18.4423554089,5.79143124447,0,2,2
dance!!,18.4412463416,4.27543107213,1,5,6
myninja,18.4400545942,4.38110947843,1,4,5
professortoke,18.427339046,6.40585935476,0,2,2
swerve,18.3924240113,6.39631598175,0,2,2
stdangerous,18.3869320511,6.13518467314,0,2,2
big d squirrels,18.3845697491,6.3955012082,0,2,2
cracker jones,18.3845696716,1.79621954184,9,28,37
master jay,18.3609401588,6.39052231831,0,2,2
shwang,18.3577767565,6.2521714548,0,2,2
nami,18.3449675847,6.12168390994,0,2,2
hasme,18.3361849291,5.59943655815,0,3,3
charlie harper,18.3330999134,6.38313840111,0,2,2
arcangel,18.3124600159,4.2856562985,1,5,6
oxycontin,18.3049578438,4.56472838053,1,4,5
mntd,18.2997015848,3.37424883227,2,7,9
silky johnson,18.2958969289,3.28338772938,2,8,10
blackf00t,18.2957405055,6.11791947838,0,3,3
quinceprince,18.2944270184,6.23604937648,0,2,2
vidya_james,18.2594631561,4.54145745193,1,4,5
jesusisking,18.2425746549,6.14038984196,0,2,2
tangpootie,18.2358530707,2.5260550084,5,12,17
blues,18.1874960602,4.80990360288,1,4,5
xlax,18.1874527175,4.71791538095,1,4,5
elmustachio,18.1178019254,6.11091424803,0,2,2
polarbair,18.1101718287,3.42942757476,3,6,9
shawarma habibi,18.098157269,3.43069860219,2,6,8
jdeezel,18.096134607,6.31705839702,0,2,2
tylenol jones,18.0758497583,6.32077271178,0,2,2
avian,18.0712867461,6.31842389736,0,2,2
chi-fence,18.0700318226,4.3957101472,1,4,5
erk,18.0475218268,6.31009962984,0,2,2
warmachine1919,18.0428187692,6.46387437135,0,2,2
sweaters,18.0428187692,6.46387437135,0,2,2
g-rabbit,18.0321178271,2.54071750903,5,12,17
firefly,17.9980023599,6.32119878345,0,2,2
drhino,17.9980023599,6.32119878345,0,2,2
yam$,17.9980023599,6.32119878345,0,2,2
astropancakes,17.9980023599,6.32119878345,0,2,2
snack?,17.9980023599,6.32119878345,0,2,2
jpoptosis,17.9980023599,6.32119878345,0,2,2
albinosaurus,17.9829924851,6.07981880581,0,2,2
lights,17.9722012086,6.29535962389,0,2,2
beaver,17.9564848443,6.3115571796,0,2,2
armagreggon,17.9114188666,3.49307258157,2,5,7
elu,17.9103929638,2.86510197097,4,12,16
√°1,17.9040211499,2.59575504597,2,11,13
frame,17.887142982,2.37968232832,4,19,23
ebay,17.8407852112,6.26851580688,0,2,2
mulkster,17.8270005524,6.29388615473,0,2,2
bc_burns,17.8270005524,6.29388615473,0,2,2
chaos pro,17.8270005524,6.29388615473,0,2,2
dhir,17.8270005524,6.29388615473,0,2,2
armor,17.8270005524,6.29388615473,0,2,2
legoman,17.8270005524,6.29388615473,0,2,2
akiva,17.8270005524,6.29388615473,0,2,2
jfm,17.8270005524,6.29388615473,0,2,2
espparadox,17.8099998026,1.6584037506,11,33,44
ccm,17.8003179007,4.04727590307,1,6,7
pajhomas,17.7990705159,4.27778070495,1,4,5
massimo,17.7929138053,5.80630293942,0,3,3
austntatious,17.7829509186,6.06931121416,0,2,2
trogdorbad,17.7782032154,4.87998203992,1,2,3
jello,17.7651578482,3.25752716429,2,11,13
aerodet,17.7626693932,6.38009936753,0,2,2
nadamoor,17.7571849257,6.26686880382,0,2,2
tehz,17.7339091298,3.39008066077,2,8,10
brambramjam,17.7281304498,6.03039661814,0,2,2
frogge,17.7193296658,5.91111489472,0,2,2
jackmehoff,17.7135963077,5.86190286565,0,2,2
charlie,17.7006913652,6.02158775086,0,2,2
liam_butler,17.6673384456,6.26628461383,0,2,2
matt47,17.6673384456,6.26628461383,0,2,2
broonz,17.6630571753,2.08386705769,7,20,27
colt,17.6613529856,6.33021997137,0,2,2
 ô·¥è·¥Ö·¥Ä·¥Ñ…™·¥è·¥ús,17.6441979245,3.89311799681,1,6,7
luka,17.6242822717,3.73620174932,2,6,8
maxi,17.6227902384,6.22931743478,0,2,2
whitegrizzly,17.6211632096,6.0044317998,0,2,2
pigwick,17.6145656845,5.7986697379,0,2,2
scootieloo,17.6025155386,5.99030365635,0,2,2
general1712,17.5779881362,5.47693709977,0,4,4
the drew,17.5773937362,2.44524201419,4,16,20
coolguy76,17.5609241085,3.39883456521,2,6,8
bozz,17.559839839,6.18922189329,0,2,2
jollie,17.5573011916,1.68913322626,11,34,45
blank,17.5269841039,5.98245346039,0,2,2
rodan,17.5167074005,5.80608254359,0,2,2
leet,17.5109189771,4.19149285232,1,6,7
gambit,17.4724485757,6.03130753421,0,2,2
maestro,17.4681984749,6.2394819151,0,2,2
chinstrap,17.4649334833,4.56998857617,1,4,5
mechanicalmarine,17.4524072942,6.30688568514,0,2,2
catlover321,17.4262170444,4.24409266917,1,4,5
sugaaku,17.4253758572,2.50242305982,5,14,19
scraggus,17.4207899857,6.18548881364,0,2,2
ponkapa,17.4008942638,4.13154481105,1,8,9
capsui,17.3735875735,4.18589418634,1,7,8
hollow,17.3362394009,5.18830596406,0,3,3
cennis91,17.3173251075,3.6034845189,1,11,12
jonnjonn,17.3150465187,1.60573211792,11,37,48
sad,17.3097710331,6.27674314988,0,2,2
spammalanche,17.294751697,5.7688928998,0,2,2
harmless,17.2905728248,6.22322606387,0,2,2
mikeyg,17.2894835768,5.66175718426,0,2,2
highlyeducational,17.2602278329,6.07035824737,0,2,2
beets,17.2574844776,5.62221721859,0,2,2
louieg,17.2302184826,5.92760188249,0,2,2
juan doe,17.2249232193,6.2595773321,0,2,2
spell,17.2097405613,3.42173119598,2,7,9
caprigon,17.1899055257,5.86001353942,0,4,4
iamlazee,17.185740056,5.94441200211,0,2,2
lv20ninja,17.177300878,3.22942326098,3,7,10
ohhhbreezy,17.1645697169,4.37309275394,1,4,5
holosly,17.1573329149,6.26923433457,0,2,2
ppdmd,17.1573329149,6.26923433457,0,2,2
kraken,17.1398541025,6.28212270869,0,1,1
superflopp,17.1398157846,2.65161678876,3,9,12
sunkin,17.1391075866,6.24032360265,0,2,2
beech,17.1372095341,3.35961038973,1,12,13
master j.j.,17.1358355436,6.24039459921,0,2,2
jgly,17.1107819313,4.24005528897,1,4,5
starcutter,17.1011463592,6.0665411989,0,2,2
driftintheabyss,17.1009098272,6.2415552758,0,2,2
amaya,17.0988004859,6.241919664,0,2,2
dinner,17.0933637711,6.08039702859,0,3,3
sam,17.0659865662,5.90317544352,0,2,2
pale,17.053419718,3.43068330371,2,6,8
zarfon,17.0353081779,6.09705358847,0,2,2
ravioli,17.0284430048,6.30597887962,0,2,2
hotsauce,17.0254324148,2.93750452428,3,8,11
second boss,17.0219597344,4.80129573207,1,2,3
mr_sharpie93,17.021854216,6.22090893961,0,2,2
black rob,16.9946507075,6.21682728317,0,2,2
drlight,16.9870335546,5.93536565379,0,2,2
kastakatter,16.9668031539,5.65212499996,0,4,4
sianvar,16.9633446681,6.49717447875,0,1,1
giggitoxin,16.9572689606,6.19807969429,0,2,2
myroknpancakes,16.9563562005,3.33339114067,2,8,10
edwin...,16.9273178368,6.23983584333,0,2,2
aubfox,16.9273178368,6.23983584333,0,2,2
azzy,16.9273178368,6.23983584333,0,2,2
paper tiger,16.9273178368,6.23983584333,0,2,2
zurdo,16.9273178368,6.23983584333,0,2,2
raxcity,16.9273178368,6.23983584333,0,2,2
digital cannon,16.9273178368,6.23983584333,0,2,2
sfgman,16.9273178368,6.23983584333,0,2,2
heisenberg,16.9273178368,6.23983584333,0,2,2
deku,16.9273178368,6.23983584333,0,2,2
d-tek,16.9273178368,6.23983584333,0,2,2
sunshine,16.9273178368,6.23983584333,0,2,2
tuna,16.9273178368,6.23983584333,0,2,2
theycallmechris,16.9273178368,6.23983584333,0,2,2
riseup93,16.9273178368,6.23983584333,0,2,2
dinkleberg,16.9273178368,6.23983584333,0,2,2
dd,16.9273178368,6.23983584333,0,2,2
j,16.9273178368,6.23983584333,0,2,2
shadow light master,16.9273178368,6.23983584333,0,2,2
draxsel,16.9273178368,6.23983584333,0,2,2
yuxminato,16.9273178368,6.23983584333,0,2,2
gaymer,16.9273178368,6.23983584333,0,2,2
sambook,16.9273178368,6.23983584333,0,2,2
irish,16.9273178368,6.23983584333,0,2,2
zombieheart84,16.9273178368,6.23983584333,0,2,2
grraffe,16.9273178368,6.23983584333,0,2,2
jazz,16.9273178368,6.23983584333,0,2,2
searcher,16.9273178368,6.23983584333,0,2,2
beekle,16.9273178368,6.23983584333,0,2,2
qk shkz,16.9273178368,6.23983584333,0,2,2
red,16.9273178368,6.23983584333,0,2,2
miles,16.9273178368,6.23983584333,0,2,2
waffles,16.9273178368,6.23983584333,0,2,2
uh what,16.9273178368,6.23983584333,0,2,2
15(ichigo),16.9273178368,6.23983584333,0,2,2
themickeynick,16.9273178368,6.23983584333,0,2,2
umi,16.9273178368,6.23983584333,0,2,2
muthaluva777,16.9273178368,6.23983584333,0,2,2
abc,16.9273178368,6.23983584333,0,2,2
rickter_scale,16.9273178368,6.23983584333,0,2,2
bearrimshot,16.8896676175,5.10139875871,0,3,3
jojohnson,16.8847446083,5.91443560749,0,2,2
dexter,16.8413449046,5.7239708887,0,3,3
krutchby,16.8366823264,6.18674458762,0,2,2
shyguyking,16.8278588736,5.63034924809,0,2,2
bunnyblast,16.8164815237,6.1927063121,0,2,2
kohenbro,16.8078355606,5.51238629639,0,4,4
castaway,16.8048785331,6.06752345676,0,2,2
m2cain,16.7880607121,6.19335774512,0,2,2
babycakes,16.7854720562,3.3753317554,2,6,8
mookie,16.7790762933,6.17549228699,0,2,2
sabe,16.7761251883,3.20344978954,1,7,8
comb,16.7718598986,3.52312957124,2,7,9
superduperfanofboom,16.7666227916,6.17256403512,0,2,2
robslabgod,16.7628618487,5.72732565238,0,2,2
halqery,16.7623061293,5.26653213215,0,4,4
vex kasrani,16.7584531644,3.46767405596,2,9,11
keychain,16.7150444538,3.82936209107,2,4,6
saltking,16.7028054293,5.18622258635,0,4,4
jungle,16.6739823426,4.84734849697,0,7,7
jerzilla,16.6612408912,6.01798349036,0,2,2
rockmix,16.6400362269,5.94252713158,0,2,2
rollock,16.6160154896,5.42553162605,0,3,3
silentknight,16.609691351,4.36384328756,1,6,7
sven stormbeard,16.6038403627,3.56579812934,2,6,8
scott,16.5972710002,6.15290821858,0,2,2
chibama,16.5781863738,4.23844187753,1,4,5
falker,16.567302774,3.30988910863,3,7,10
jpeghero,16.5542790113,5.72001128222,0,3,3
madara,16.5392700291,5.28571396053,0,4,4
instacover,16.5173598147,6.03304199256,0,2,2
atari,16.5048660549,2.46776212888,5,15,20
lunarnova,16.4974489341,2.03491828046,6,32,38
ejmp,16.4965744596,6.14530357824,0,1,1
dmolz,16.4944034609,4.97088534466,0,4,4
curiousplaces,16.4686400239,5.98022918707,0,2,2
jedipanda,16.4647915137,4.78519132867,0,5,5
mattatari,16.3756506231,4.37007791415,1,5,6
nnaughtydogg,16.3737904301,5.12906693269,0,4,4
bogmyer,16.3677235569,5.87555636419,0,3,3
magfmur,16.3354417012,5.811464978,0,2,2
nuggz,16.2887364896,3.61112952013,2,10,12
recneps,16.26011104,4.30110440634,1,6,7
dr gibs,16.2021899007,5.23131951349,0,4,4
duma,16.1172731809,3.63223511183,1,8,9
thegoat,16.1110336081,6.0577218926,0,2,2
rocktimus crime,16.0992903732,4.77460142995,0,5,5
lord horatio,16.0955200048,5.5603136349,0,4,4
bill,16.0460514931,3.8741798958,1,6,7
i use tap jump,16.0323662573,3.71753345074,1,6,7
scruffy mcwonder crumpet,16.0242379386,3.29357881652,3,7,10
jedisalazar,16.0199757813,5.71550570122,0,2,2
frog,15.9975729291,4.49544849198,1,4,5
bluey,15.9662421237,5.36492827488,0,4,4
bennypuff,15.9422202049,3.5281410014,2,7,9
elitescoringguy,15.9196601869,2.56385764405,3,14,17
mrkymrk,15.9106960422,4.79558024562,0,5,5
redwolf,15.8831330222,5.97846405882,0,2,2
noelkitten,15.8731505615,5.65452520089,0,2,2
eclipse,15.8691401021,5.17864801317,0,4,4
yolft,15.8455387002,2.4155974637,2,21,23
12ties,15.8352715605,3.47806136276,1,5,6
thedarkdreamer,15.802391653,6.01484204148,0,2,2
codytappen,15.7853216507,5.6088576584,0,2,2
lampyshade,15.7852907855,5.40869234116,0,4,4
jackkenney,15.7585225492,5.64899828726,0,2,2
blahguy,15.7454563257,5.81008494948,0,2,2
turquoise,15.7347546756,3.26486622961,2,7,9
lloyd-black,15.7316993222,3.58247607771,1,8,9
vondo,15.7240700032,4.72021122034,0,5,5
twunt,15.7120747404,2.91236324449,2,13,15
2%gay,15.7115970751,4.07004240673,1,8,9
don,15.7070788051,3.5589052303,2,5,7
spaz,15.6941337488,4.1897867752,1,4,5
norwayray,15.677070514,5.25281436314,0,2,2
dk dredd,15.6475640437,5.91830761396,0,2,2
mm720,15.6459947778,5.58336375981,0,4,4
kobra,15.5962540566,3.16462826259,2,11,13
uncle onion,15.5522960143,5.93876560258,0,2,2
katiebug (sfk),15.5257668944,5.60340187496,0,2,2
tydye,15.4962095478,5.71435404844,0,2,2
bennyboy98,15.4862446417,5.96174045904,0,2,2
swankeaboo,15.4643931447,4.83726238963,0,6,6
shimshamlando,15.4224055427,2.30889700623,4,28,32
fmaj7,15.3958842528,3.88187056051,1,6,7
lou sanus,15.3809767544,4.5666113781,0,6,6
t-bone,15.3739395325,3.41391445547,2,6,8
mzadeh,15.3369856218,5.22457785758,0,4,4
peacemaker,15.2835413484,4.37858910356,0,6,6
tanuki,15.2414745664,5.77050178339,0,2,2
lvl99wizard,15.2283681425,4.90144194929,0,4,4
tron,15.2083393057,5.60692837727,0,4,4
mariokartmoney,15.2023991933,5.46979181665,0,4,4
vnko,15.1942653345,4.14617582497,1,4,5
ir,15.1930538463,3.90186383441,1,6,7
godspeed,15.1675586068,4.06536906148,1,7,8
kezzup,15.1452826627,3.62942140819,1,8,9
bagel,15.1356957542,5.1963265951,0,4,4
dude wut,15.1318212909,4.51034036508,1,4,5
thisisgettingold,15.115537955,5.93072884891,0,2,2
bung0o,15.0861921012,5.20344175089,0,4,4
zbomber,15.0509843753,4.94130092061,0,4,4
warhorse,15.0442469388,3.76730668261,1,6,7
rumi1819,15.032737297,5.25192924325,0,4,4
fry,15.0081453273,2.92602117181,2,13,15
wiseacre,15.004310267,3.59470410489,1,11,12
dyo,14.9906479002,3.54205350791,2,6,8
dr-wumbo,14.9839655426,5.50492602216,0,2,2
ceephax,14.8595237801,5.78946898394,0,2,2
hufff,14.8480690262,3.63044526474,1,6,7
captainpugh,14.8452902214,5.52853616448,0,4,4
fig,14.8379883515,5.44294090835,0,4,4
adulix,14.7935449934,4.99541774313,0,5,5
bchill,14.7325117016,3.21476912462,2,7,9
meccs,14.6968757737,5.01915984619,0,5,5
snoosnoo,14.6669266362,4.23922589243,1,4,5
feartheday,14.6259107644,2.88655787416,1,18,19
cnasty613,14.620508407,3.46789419253,2,6,8
kevorkian,14.5936266659,2.82544047409,3,13,16
showtime,14.5887361904,5.82355811529,0,2,2
bear,14.5885031086,5.31724245585,0,4,4
drunkn smash,14.5538202043,4.50683129225,0,5,5
goofinhiemer,14.5181999644,4.98940140825,0,4,4
midgetto,14.5048098849,2.31164121972,4,18,22
fmax,14.4895155373,5.50407742618,0,4,4
marfthekid,14.4759756441,5.52615164682,0,4,4
yaks,14.4259477741,3.69156960904,1,8,9
hiddenmi$t,14.3549615492,4.93628860656,0,4,4
cag,14.3368913197,5.13462413617,0,4,4
ngwn,14.336028572,3.40029971735,1,9,10
armadillo,14.3354231832,4.55680465741,0,6,6
ryden hope,14.2910190469,5.6998136168,0,2,2
dennysgrandslambreakfast,14.2817644011,5.15765548501,0,4,4
auggie,14.2389167138,4.08002724065,0,9,9
rhubarb,14.2328670892,2.402614829,3,18,21
sevshun,14.2320230071,3.41148367163,1,9,10
usvn,14.2288207589,3.37372047253,1,11,12
spaghetti,14.208758168,3.01899339865,1,11,12
cgmontage,14.1774498365,4.15533758377,0,7,7
fj20,14.1131439588,3.17526873157,2,7,9
primefry,14.0910554682,3.06740565702,1,11,12
chacalaca88,14.0571242049,4.51019307891,0,6,6
godofgrunts,13.9867594184,4.75521899531,0,7,7
hiv+,13.8906179216,3.40076433745,1,8,9
myk,13.8626267077,5.36647171848,0,4,4
edgar allen pwn,13.8507948829,3.61744450376,1,10,11
oquinn,13.8478205786,4.40150344376,1,4,5
chibaco,13.8466080084,4.24056462993,0,8,8
telemonic,13.8419944418,5.11085179691,0,4,4
road-rage 64,13.7961423154,4.50198810499,0,6,6
turtle,13.774848283,4.39915568102,0,8,8
bort,13.7662001173,4.06955310695,0,6,6
frapple_apple,13.702514154,3.50806837661,1,7,8
rich,13.7007160926,4.94211244526,0,5,5
mf space,13.6988638631,4.73219964716,0,5,5
kronk!,13.6567991162,2.63839087706,2,18,20
scruff,13.6055907953,4.97176602281,0,6,6
mattc,13.5946512718,4.33245051686,0,5,5
lotionhole,13.5935109387,4.41526720554,0,6,6
mike4real,13.5794029074,3.33466768673,2,10,12
bluntsmokinganusdestroyer,13.5612010145,5.3496943539,0,4,4
cat,13.5100554597,4.71980783012,0,5,5
hashi,13.4986029024,2.43768387948,3,22,25
whiz kid,13.4212074591,5.16852123362,0,4,4
blanco mano,13.4015177081,4.59893174621,0,5,5
heavy,13.368224061,4.15924595481,0,5,5
scaryman,13.3668329574,4.32703399476,0,6,6
ben,13.3586175424,2.55043746989,2,16,18
woof,13.2208606529,5.01298816141,0,5,5
hwatts,13.1874865343,3.67685789425,0,13,13
mop,13.1849998805,3.2805264237,1,8,9
dabs?,13.1803977711,4.09630810175,0,9,9
neff,13.0930152781,5.55738961508,0,3,3
gato,13.0916622289,4.41769470327,0,5,5
greatwhitebuffalo,13.0279112833,4.66408273906,0,3,3
sour,13.0147323382,3.7536606962,0,10,10
oldiz,12.9584536241,5.08223751624,0,4,4
weslec,12.9078481002,3.74964674283,0,8,8
brother quang,12.9017526918,3.33542459669,2,8,10
lotus,12.8998215032,5.47731754622,0,2,2
zorro253,12.8826940823,3.25259540748,1,10,11
monica,12.8133167623,4.5803659133,0,5,5
boogie!,12.7702565627,3.01419124321,1,14,15
nardwell,12.7071033178,1.87972085723,6,45,51
rokd,12.6842001949,4.62714471408,0,4,4
twisty,12.6816621596,2.58165700612,2,27,29
jimbot,12.5261010076,4.50079562529,0,7,7
phynque,12.4719890049,3.45427818698,0,12,12
atlas,12.4569151176,2.97012274026,1,13,14
gasmask,12.4310841111,3.9149956174,0,8,8
tyler_stewart8,12.3118599584,3.60294784254,1,6,7
fabulousboy,12.3106376565,3.83504361201,0,9,9
terrible fate,12.2809947822,3.52135803704,1,12,13
putpasswordhere,12.2399340297,4.50345164952,0,8,8
neph_girl,12.1193810114,2.95394737179,1,14,15
ohb-noa,12.1028007786,4.13575462941,0,8,8
doublej,12.1005353451,3.5699328287,0,13,13
lolitaz667,12.0453758947,3.33021716368,1,8,9
b rod,11.8019450585,5.01595212606,0,5,5
syph,11.7425065427,3.6344889055,0,9,9
jame,11.7110692097,3.36764771913,1,10,11
little things,11.6546306634,4.00999959174,0,7,7
nicklebackair,11.6203561598,3.50505869044,0,9,9
whitezebra,11.5405764946,3.58168062343,0,10,10
mambo,11.4464915665,4.89576582551,0,4,4
half man,11.4034099374,3.67201092407,0,8,8
microwaved hotdogs,11.3768900742,4.0999063488,0,10,10
baloo,11.3373148454,4.48842829345,0,5,5
t3rquoise,11.3248899372,3.8345238346,0,10,10
stormcrow2,11.2978295008,3.47060674469,0,9,9
ranger,11.2314317705,4.06818869192,0,10,10
reject,11.0858639604,2.5125765953,1,27,28
mello,11.0184992019,3.16662161364,1,16,17
qwesseccssffdy,10.9109266691,4.93789520412,0,4,4
stevenballoons,10.884359982,3.14209059588,1,9,10
jerry bean,10.7641084019,5.18242083662,0,2,2
2p,10.526599751,3.31660842801,0,16,16
knothy,10.5130416611,3.62780757138,0,12,12
ceec,10.486437518,3.43670972894,1,10,11
brizzles,10.3907624866,4.01676234857,0,8,8
lloyd.,10.1849917874,3.63899086344,0,9,9
