player,mu,sigma,wins,losses,sets
yung duccboii,9.91135358513,3.95971073977,0,7,7
hwats,9.90124804057,3.56266251505,0,12,12
seaniemaster,9.64241862385,3.79627520937,0,8,8
macrado,9.53515860148,3.41574621757,0,13,13
gluu,9.51908954319,3.89497213025,0,6,6
jet fuel,9.33006517351,2.90079656741,1,16,17
soggy biscuit,9.19269279891,3.41970880973,0,9,9
seaweed dragon,8.99323094424,3.70386803446,0,8,8
golfclubninja,8.65443973918,2.81299405173,1,28,29
archduke,7.48447217196,3.60677942819,0,9,9
superboomfan,51.0479431694,1.18934907207,187,11,198
alvin,49.0563613986,1.20324478678,87,11,98
fukurou,48.8483583106,1.56849986479,42,4,46
wizzrobe,46.2462228952,1.10270155657,101,21,122
mariguas,46.2416736858,1.10206934685,102,22,124
kysk,46.1856867233,2.04085966737,18,4,22
kurabba,46.0625852212,1.91926942095,20,4,24
wario,45.8723558691,2.29125245625,18,3,21
wangera,45.620173562,1.69989656274,29,7,36
kerokeroppi,45.0918938728,1.10628438307,83,23,106
dext3r,44.9789190617,1.15479722463,77,20,97
isai,44.6896548722,1.25991859929,68,15,83
tacos,44.1622647921,1.19849680541,80,21,101
zero,44.0330751516,1.10639189185,92,22,114
fox,43.4824015641,1.29535888319,56,12,68
prince,43.3265082784,2.1403747265,17,4,21
joshi,42.6631449003,1.84714309764,21,5,26
tr3gthez,42.5643094582,1.21525260473,63,19,82
brody,42.44560877,0.952456499743,180,55,235
lowww,42.2199474003,1.34849970945,53,11,64
revan,41.9346164826,1.16361287177,65,22,87
gyaki,41.904737333,2.64199452362,11,2,13
yu-kun,41.6790960514,3.05228990998,5,2,7
hiyo,41.5990350709,2.69831387677,9,2,11
taimai,41.2131913957,2.99882201906,5,2,7
stranded,40.8601322985,1.21333995417,63,19,82
bloodpeach,40.2506029006,3.19707916251,9,2,11
lord narwhal,40.1166003353,1.18077593824,60,20,80
robert,40.0099655555,1.31306392558,44,15,59
dtan,39.7936028619,1.61313695864,24,10,34
jaimehr,39.7848080461,1.25791649615,48,21,69
firo,39.697658111,1.45970640428,35,14,49
cobr,39.5298627023,1.29559780972,45,18,63
hammerheart,39.2001955233,1.26116979252,55,18,73
kort,39.1727802202,1.73413867325,26,10,36
shalaka,38.968419208,1.66824477421,27,11,38
derek #squats,38.8419594233,2.13064325542,11,5,16
sheermadness,38.6532861266,2.05549132515,16,6,22
czar,38.5874731701,1.68391050923,28,9,37
banze,38.5738127634,2.4543127245,11,5,16
hero pie,38.5089002807,1.96635590721,18,8,26
kd3,38.4030391362,1.05706062685,83,27,110
heropie,38.3318534665,1.88301004381,20,7,27
ctg,38.3020275192,1.0547497874,86,32,118
fireblaster,38.231960018,0.938843199715,138,53,191
star king,38.1472048977,1.26208105443,50,20,70
nacl,38.0203022576,1.35162281783,43,18,61
handsometom,37.7394112942,2.02998436936,14,8,22
combo blaze,37.6809544658,1.45583694437,37,16,53
clubbadubba,37.6277135962,1.56856017486,30,12,42
manjaro,37.6216724964,3.14912315508,8,3,11
kimimaru,37.6107476669,1.55764177955,29,14,43
bonobono,36.9965762617,3.29635424318,5,2,7
nta,36.9164599913,1.72497338483,23,10,33
janitor,36.7289767003,1.30418043936,51,21,72
janco,36.7224918852,1.73585631145,21,12,33
stevie g,36.6524895823,1.43800620864,38,12,50
kyle tree,36.4882628982,1.91308859045,18,10,28
loto,36.4834675869,1.26716123019,40,19,59
shears,36.4723432873,0.951790644129,134,58,192
marbles,36.2990879316,1.18148723834,54,22,76
skg,36.233170641,1.27333324886,36,18,54
ybombb,36.2272374052,2.22363538313,12,8,20
darkhorse,36.1534005476,0.946163787073,101,52,153
greginator,36.1481738962,3.48114118021,4,2,6
finio,36.1433984819,1.24573424719,44,21,65
nintendude,35.841393813,1.19817220157,53,29,82
yunque,35.7958757999,1.4708408249,31,15,46
horbie,35.523871568,1.16580529428,61,29,90
roman,35.4745969745,1.50756435469,34,16,50
lorenzo,35.3697514862,1.65713703461,24,11,35
hydra,35.3094073732,1.7037077214,23,11,34
antwon420,35.041926364,1.9906921426,15,7,22
fumbles,35.0360029237,2.15188026392,14,6,20
nothing,35.0178450691,2.24135050833,14,6,20
jose,34.9831701735,2.61197335236,8,4,12
sotoh,34.8531466434,1.45906069194,33,19,52
purple circle,34.8374057831,2.83980775246,12,4,16
blondekid,34.8000451075,1.71681636264,22,11,33
jason,34.7993221729,1.63775167175,26,12,38
amida,34.6764205455,2.26888997825,12,7,19
vinsanity,34.6595018827,1.87373186747,16,8,24
$$$ jim $$$,34.6427240996,1.44476161273,32,16,48
hotline,34.6253311538,1.66226545424,21,11,32
letsgo,34.4678343663,1.82810191751,19,12,31
fray,34.4563783239,3.36077840293,3,3,6
daniel,34.3722172994,1.62932123744,21,14,35
dark gentleman,34.3452058491,1.16700532211,50,26,76
jam,34.337570351,2.58862509125,8,5,13
supa,34.2726256156,1.59763244161,22,13,35
yobo,34.105876141,1.12772049389,54,32,86
gravyfingers,34.0871399076,2.04834733618,17,8,25
sax,34.0855003085,2.41059442467,10,5,15
connor,33.8816008991,1.92956083694,20,10,30
eg,33.8765811838,1.47402965344,28,16,44
freean,33.865985989,1.32167081368,37,21,58
the ki of chaos,33.8332628989,5.89402292155,1,0,1
james3927,33.6426436035,2.52686545775,11,4,15
masterhandjob,33.641467281,1.11494735336,54,30,84
madrush,33.586456659,1.02896489581,66,46,112
wookiee,33.5030956065,1.33056736645,37,22,59
hipstur,33.4607171566,1.22416123213,51,25,76
b link,33.4210302855,3.4233122782,4,3,7
pugs,33.3822012702,1.26203206375,35,24,59
time machine,33.3781486945,1.2467600839,44,26,70
schickler,33.3255764516,2.59306678435,9,4,13
sextc,33.3182090992,1.628719786,21,16,37
butt solo,33.3123084348,3.84667442858,3,3,6
satan [turner],33.3043093714,3.29711714346,4,3,7
fishaman p,33.2740791831,2.40097978322,9,6,15
raychu,33.2617733026,1.24351896601,47,22,69
dajjal,33.2392869643,1.71545517999,22,13,35
fruity,33.2334604019,3.52258587025,5,2,7
facechew,33.1235160338,3.94508944253,5,2,7
sedda,33.0156727069,1.3556613943,36,20,56
near,32.9834601142,2.15933280057,12,8,20
zeppelin,32.9315705413,3.10089909277,5,3,8
bo,32.9188174268,1.99945325336,14,9,23
indefa,32.899218324,1.93512205574,19,9,28
monte,32.8907637535,1.92095040953,15,6,21
smash jesus,32.8772466544,2.29388084063,14,6,20
sunnyb,32.7879977522,3.56449745895,4,3,7
andykins,32.7636031228,1.54303821243,25,13,38
the protagonist,32.760735541,1.16574727785,50,32,82
mr.sir,32.7143110574,1.12238205438,55,35,90
mojomonkey,32.6581370625,2.20026741003,12,7,19
dr. grin,32.6530724392,1.88728057178,17,12,29
cyoonit,32.6163749725,1.87088846867,14,10,24
dogs_johnson,32.5799816249,1.24356998453,42,25,67
j.moosh,32.579603108,2.80261314173,9,4,13
shihman,32.5613527208,1.30742471615,42,25,67
nickelbackstreetboy,32.5484707936,3.54608000495,4,2,6
preston,32.5434052467,1.33890746596,38,22,60
the big d,32.407643044,4.09802043876,4,2,6
poobearninja,32.4037778794,2.84303906931,9,4,13
stonefallow,32.392499565,3.49415537303,6,4,10
jay_mute$,32.3029580481,1.68333105714,20,12,32
dishier wand,32.2947746686,1.38845656078,31,23,54
th3kuzinator,32.2195835115,3.33454023191,6,4,10
subtle,32.1073751521,2.33176056147,13,9,22
gildo,32.0696930946,1.5466005609,27,14,41
the dark gentleman,32.0509317121,3.552146823,4,3,7
eggmode,31.9840503236,2.0984334227,13,11,24
b0n,31.9822767556,3.9641478883,4,2,6
weedwack,31.9699117113,1.5677211019,21,17,38
knitephox,31.9450771041,2.41855201508,10,7,17
jay-r,31.929444546,1.52482153954,26,15,41
dogg,31.9213758108,2.58725412792,8,6,14
snorlax,31.9185680871,1.95236552223,15,10,25
ken,31.8110244458,5.40169263758,2,1,3
elel,31.8026868137,1.54050718226,28,18,46
spongy,31.7813272954,1.25525628585,39,22,61
tank,31.7386395965,2.49251569036,10,7,17
qapples,31.6923064677,1.32846103833,32,26,58
bp,31.6535565377,2.20409341058,11,7,18
spark,31.6297182442,2.75594821915,7,4,11
socrates,31.6151067194,2.5147487468,7,6,13
battlecow,31.5939869488,3.4016171486,4,3,7
nattybroh,31.5369189623,2.65377269796,9,4,13
d35,31.5367109495,1.50082872912,26,18,44
kirbstomper,31.5188344006,3.86445858352,4,3,7
bard,31.5125372418,1.27203298598,35,28,63
moosh_da_moosh,31.4941425132,2.09133994481,14,8,22
dr. lampy,31.2480624189,1.62160064869,18,12,30
commander,31.219157037,4.42278572814,3,2,5
a to tr3gthez,31.2052346468,2.11350234695,11,10,21
josephzander,31.1977877538,3.43202608064,5,3,8
komotonoto,31.1741767639,2.27903272606,11,7,18
g0d,31.1403348642,4.50048660197,2,2,4
deathcpo,31.135120199,1.26749719793,35,26,61
saltsizzle,31.1328798402,1.74278001077,17,13,30
rossi,31.1312028168,4.20548682927,3,2,5
pete,31.0990824104,3.62685915722,4,3,7
q!,31.0887585912,1.28525809209,38,28,66
tyhiggz,31.0830785328,1.18354725262,43,30,73
kaz,30.9665373576,1.15636705046,51,31,82
studstill,30.9310670975,3.00777583832,7,4,11
ivor,30.8866197892,4.09947611008,3,2,5
jimmy joe,30.8835850053,1.07982048147,46,45,91
fck vwls,30.8214324917,2.26391326197,10,11,21
shanks,30.8108401106,2.93696326187,6,5,11
repsguy,30.789651329,5.04040345974,1,1,2
gunnermaniac,30.7790611133,1.97367873841,12,10,22
miniohh!,30.7712290304,1.64813246532,20,13,33
se√±orhen10r,30.7195440697,3.45201857995,4,3,7
paco,30.7182537688,1.32242447649,34,26,60
tot,30.6935093983,3.09561865676,7,6,13
inukem,30.6870299912,3.45386431702,4,2,6
a$,30.6502257157,2.35680013019,10,6,16
rusty,30.5865740847,1.2271599915,34,28,62
dubs,30.5848088535,3.18209149888,7,4,11
limesoda,30.5787346747,1.65579544732,21,15,36
zeozen,30.5121863802,3.97389583729,4,3,7
scoback,30.5112699654,2.44473664251,9,9,18
jamjar,30.5021457552,1.08935942115,53,43,96
bowl,30.4980955853,1.64205296956,19,17,36
therm,30.4436066815,3.99029094944,4,2,6
american patriot,30.4103417977,2.35523208174,8,5,13
joker,30.3808479488,4.02600400939,2,3,5
bread,30.3739620407,1.74047137866,17,15,32
natty,30.3730448897,2.7856143691,7,4,11
skyfire,30.3404860835,1.83362094511,14,12,26
the (.)(.),30.2759309914,2.36859190623,9,7,16
emptyw,30.1606814919,2.68107538156,8,5,13
korobeniki,30.1471756931,1.2746496543,38,28,66
llcstoism,30.1255502333,1.72932330608,17,15,32
captain l,30.1229521543,1.89480658491,14,15,29
captain fabulous,30.0915998267,1.5967868876,23,18,41
pizza jokes,30.06111398,3.52302027129,3,3,6
rith,30.0135657531,3.90958200199,3,3,6
yoleo,29.9717805732,1.93464515753,13,12,25
fancy,29.9518204603,4.24685236426,3,2,5
nyx,29.9362791433,3.2123315193,5,4,9
mokkori,29.9221620874,4.18659466566,3,2,5
b33f,29.9194729082,1.3582276202,30,21,51
bt,29.9012482777,2.19788219403,9,8,17
onski,29.8831743941,1.49967569331,25,24,49
v,29.8576841009,1.38111081594,29,25,54
moogle,29.8328805413,4.33168728203,3,2,5
heny935,29.7663175994,3.94718579012,4,2,6
crockett,29.7118709887,2.44712460996,8,6,14
daniels,29.6848611388,1.47266038364,27,20,47
spamus,29.6775492772,1.30686524278,30,28,58
olbus,29.6740548915,3.96108120221,4,2,6
razz,29.6693115359,1.04334064518,61,46,107
reptar,29.6285392518,1.30215824869,34,27,61
lob,29.6189890712,2.58359726416,7,5,12
mr. wang,29.6048887164,4.10245695982,4,2,6
m-angry,29.5669518559,3.08372170091,6,4,10
bert,29.518071561,3.99480885129,4,3,7
pewpewu,29.5121370167,3.04406287749,8,5,13
wincancel,29.4766593076,2.66422694344,8,6,14
umbra,29.4752212703,3.27260665752,6,4,10
quitrage,29.4707454384,3.26089787172,5,4,9
newbtube,29.4568876214,2.73376498047,5,5,10
the american patriot,29.4373245494,4.21048447834,4,2,6
sheick,29.429273054,3.12414924558,6,5,11
rocket,29.4225925309,1.33652858409,28,25,53
piratetrips,29.4211027898,2.81001356653,7,4,11
charky,29.39583202,7.17147558733,1,0,1
blue,29.39583202,7.17147558733,1,0,1
stingers,29.39583202,7.17147558733,1,0,1
sarge,29.39583202,7.17147558733,1,0,1
sampai,29.39583202,7.17147558733,1,0,1
dublat,29.39583202,7.17147558733,1,0,1
greeno,29.3737487224,1.6595411454,23,15,38
jxc,29.3254518011,2.11437778926,11,8,19
logic,29.3210571583,2.10035318278,10,8,18
thord's bro,29.2792067998,3.13119803555,5,4,9
t-beau,29.2661426508,2.79010861016,7,6,13
0prah,29.2585250017,2.84842360964,6,6,12
morino,29.2260895886,3.85461294267,3,3,6
natendo,29.2245495489,2.06945909658,12,8,20
yrn,29.1993823768,2.43289516195,7,6,13
bamster,29.1843497122,3.55877030789,5,4,9
bigfish,29.172759821,2.72762724995,6,5,11
reefybeefy,29.1458192764,1.84344256206,14,13,27
dizzle,29.1356519202,1.37353606116,26,27,53
annex,29.1170675534,1.8090530355,18,14,32
fil,29.1117471473,1.41442924074,24,26,50
mustard tiger,29.0995072215,3.32198432043,6,4,10
aerosheep,29.0752383621,3.97125305516,4,3,7
toro,29.0095603006,4.38928209674,3,2,5
chet dunskies,29.0076263982,3.42632846118,5,3,8
kyle,28.9911525189,2.56729888883,8,6,14
touque,28.9823537595,4.27259275633,3,2,5
nesskhalifa,28.9680768905,1.73406376984,16,16,32
duffman,28.9576994666,4.44491789939,3,2,5
gt,28.9554845526,0.922671422963,90,79,169
allgreen,28.9223919819,2.4503187505,7,6,13
king lumsy,28.8996450434,2.65509773177,7,6,13
broly,28.8374272901,4.38916703232,3,2,5
backes,28.8053643448,4.49134336743,2,3,5
elvis,28.7587498633,4.26553689379,3,2,5
pathall,28.7271970168,4.69344711303,2,2,4
fenlet,28.6601962264,4.79453300435,2,2,4
a la carte,28.6131211007,3.55538815759,5,4,9
kelvinheit,28.5896561198,1.43536381204,29,19,48
breakthrough,28.586417259,1.94227072717,13,14,27
bon,28.5610273459,2.76799682546,7,8,15
birdlordmasterbeak,28.5429251864,7.1211258753,1,0,1
zuko,28.4989701135,1.94286047091,16,14,30
cam,28.4710068478,1.97887738879,10,12,22
epic!,28.4182235482,3.01694141585,6,4,10
darkneon,28.4157960148,4.4070657674,3,2,5
slappypoopy,28.4033942753,1.59184774326,22,18,40
purtle,28.3840947103,1.96366199805,12,12,24
smurf,28.3330765581,1.26710409577,41,32,73
phut,28.3223415456,3.99197197983,3,3,6
tvdonk,28.3203937299,4.45958674045,3,2,5
ibc,28.3130419186,3.36281447405,4,4,8
coin chaser,28.2990279648,4.40912520839,3,2,5
tonester,28.2571026619,2.04969721343,14,10,24
bloogo,28.2366279478,1.14717108252,39,37,76
blaise,28.2055181803,4.52219949795,3,2,5
peasantloaf,28.1958652619,4.26248928484,3,2,5
jsmirk,28.1857294903,1.5116696628,26,22,48
autobaun,28.1529055021,4.53845634446,3,2,5
bacorn,28.1436498056,2.47567422153,9,9,18
nattyb,28.1340321176,4.41412338,3,2,5
cody,28.1087830626,4.80396471385,3,2,5
toronto joe,28.0996945701,4.53051547838,3,2,5
batterybird,28.0646892936,4.53376969681,3,2,5
kraines,28.0154055579,4.8746850721,3,1,4
sebula4,27.9711233548,4.45140829467,3,2,5
mr. slimey,27.8861676951,4.73510882063,2,2,4
professor_wizard,27.8821590677,1.43542482595,29,22,51
box765,27.8651839969,1.38168809863,21,25,46
anotherish,27.8480172074,4.74511802982,3,2,5
enneielle,27.8195884603,3.84402021199,3,3,6
taiko,27.7901482209,2.48686928205,8,9,17
kriskringle,27.7731932235,2.88057239132,6,5,11
dragoniota,27.7660977373,4.48734501111,3,2,5
automatic,27.7594036868,1.63734360273,16,19,35
xor,27.7306959177,4.55622523955,3,2,5
hack,27.7051773304,1.66538490124,19,17,36
velocity jones,27.7021387548,1.21550962031,34,34,68
waxy:joe,27.6911748529,1.34450401311,24,25,49
zyrg,27.6875599983,3.14537362783,5,4,9
maliki,27.6830377157,2.04480977998,13,11,24
xyk,27.6764184763,4.4512066855,4,2,6
rishi,27.6450709456,5.64680452515,2,2,4
kabal,27.625076721,3.87756274923,4,3,7
marlwolfe,27.552619447,3.82671112369,3,3,6
quickcav,27.55040182,3.25546867637,5,3,8
shake,27.5338781153,2.74924040943,6,7,13
t0mmii,27.5268971516,4.50511998972,3,2,5
maniac379,27.4914049316,1.31675541517,31,33,64
viberant,27.48916811,2.45581351256,8,7,15
duff man,27.4414094749,1.91187065912,12,14,26
darv,27.3717117647,2.29064873061,9,10,19
r6=s2=(sr)2=1>,27.3704880959,3.74488192697,3,2,5
my buddy mike,27.3630733325,5.18234526133,2,2,4
fake,27.3074877276,3.34956699934,4,4,8
toa,27.3056488335,5.4281468828,2,2,4
beans,27.3011585926,1.70930734356,18,15,33
dpb,27.2936032517,4.60076381324,3,2,5
ern,27.2752491302,4.52152801546,3,2,5
1000,27.2336915033,5.26256748611,2,2,4
maze,27.1527115014,4.91674913149,2,2,4
ringedge,27.148449228,1.57723605105,20,16,36
p21/c,27.1459858702,1.87563992001,13,15,28
okuser,27.13111554,2.21152503832,8,10,18
meromorph,27.0857756082,5.02208635203,2,2,4
pizza,27.0830735904,1.51969073745,23,25,48
freddy cougar,27.0208363255,5.4314485912,2,2,4
sunflower,26.999761242,1.37879201251,25,28,53
vudujin,26.9460054325,4.79897904172,2,2,4
jnatty,26.9078530168,3.10222577524,6,6,12
the yid,26.9045378738,1.14888071463,42,45,87
stevie g$????????,26.8839571217,5.02153563927,2,2,4
cam2,26.8488900794,2.34249852119,7,8,15
mr.watchandlearn,26.8453200038,5.13273670901,2,2,4
vanddar,26.812335727,4.90847115312,2,2,4
flanders,26.8071366693,2.79984418256,7,5,12
big dick damage,26.802480442,3.23243451971,4,4,8
hoofy,26.79127978,1.63448643199,21,18,39
kaladin,26.7588062893,4.84757461904,2,2,4
kirbyrocket,26.7571346222,4.30484211868,3,2,5
walkrofsky,26.7536421158,1.75962627643,12,17,29
cwic-beam,26.752600531,1.92043797418,14,14,28
maps,26.7138155195,1.50867579826,20,21,41
fudgeball,26.6801323654,4.1606982305,2,2,4
rizner,26.6744699793,1.92377669053,14,14,28
no~m,26.6636890799,2.78947724224,7,6,13
blue lantern,26.6378155075,4.90779834159,2,2,4
sav,26.6355932201,2.34298511164,8,7,15
shyboy,26.6343030405,4.82060840724,2,2,4
el man,26.5873778811,2.59728951608,7,5,12
synth,26.5707186862,4.42243348254,2,2,4
dam_tewton,26.5407410776,2.59990635673,7,8,15
gooby,26.5011810227,2.79539236159,6,7,13
whitejesus,26.4694025266,1.23612160437,30,36,66
dad,26.4625686357,2.89354821478,7,5,12
oh thomas,26.4621098535,4.31062255189,3,3,6
mando,26.4487466782,2.1741394701,10,13,23
salami,26.4455499011,3.03354943217,6,5,11
nalgas,26.4324148357,4.52154689818,3,2,5
k rool,26.4202466246,1.75990001235,13,16,29
killahertz,26.3643937395,3.04031012948,5,6,11
stonehaus,26.3144683052,4.85649340991,3,2,5
thomdore,26.2874882903,5.07805052396,2,2,4
cam1,26.262010826,2.50863506247,8,7,15
white,26.2127601873,4.45860810546,2,3,5
stew,26.1846971921,1.30475454186,32,34,66
hhhhhhhhhhhhhhh,26.1805605948,4.94442759964,2,2,4
droc,26.1642028427,1.37359193605,24,29,53
king funk,26.1614294024,4.11670584893,2,3,5
hypa,26.1258403992,4.79492866376,2,2,4
doughnut,26.0785943368,4.74066176482,2,2,4
shishkabobs5,26.0718708003,5.37780397789,2,2,4
toxic,26.034888485,1.88779401915,13,11,24
flatvi,26.0277578824,4.22394609143,3,3,6
ham,25.9645990351,1.83746436741,13,16,29
boomalready1,25.9453830841,3.75152378119,3,4,7
bringdaruckus312,25.8961482234,4.91181907561,2,2,4
bigbeaver,25.8581705325,1.30685155882,26,34,60
mortech,25.8560905065,1.68262344898,17,19,36
bunz,25.8165022573,2.20223498789,11,15,26
collin,25.7981094167,2.28137664619,9,9,18
cmull,25.7646158657,3.4504720971,3,4,7
hoofydough,25.7113062928,4.91600928402,2,2,4
ace,25.6600974911,1.59568160825,16,21,37
lookalike,25.6377991163,3.68278876889,4,4,8
traiman,25.6346989879,1.96468914648,11,14,25
blmb,25.6131868917,4.75084940272,2,2,4
webwipe,25.6106134963,3.38256458333,3,4,7
sebula,25.606382901,1.26892789769,29,35,64
le_vinny,25.6052802202,3.31729606434,4,4,8
z-rex,25.6030321597,2.70834950691,5,8,13
slappymcnutz,25.6016510579,1.97642928981,9,14,23
meerkat,25.5830177788,2.38833218394,9,10,19
komodoninja,25.5719452624,2.70071885036,8,5,13
scratch,25.5707110662,1.8694535245,13,16,29
j9d2,25.5678331018,4.26488499498,2,2,4
tbq,25.5638398329,3.35544412538,4,4,8
chuck lubs,25.5606773425,5.02116683742,2,2,4
prime,25.5360295693,1.67278541931,17,17,34
hariballz,25.5320289049,3.41696308649,4,4,8
baby legs,25.5159187575,2.56142384458,7,7,14
funkykong,25.5050742126,4.87107097566,2,2,4
ttt,25.495761317,3.0148570358,3,6,9
justin,25.464129502,2.69572885256,7,6,13
mixxedvegetables,25.4501743805,4.70204997659,2,2,4
griffith,25.418415069,1.43360978571,20,26,46
jlo,25.4120316069,4.81805105085,2,2,4
log,25.4009493355,2.96222615239,4,6,10
snowstorm,25.3934923152,4.93156978565,2,2,4
t brett,25.3671626614,3.85884397536,3,4,7
starchifox,25.3611312572,2.95232769534,6,6,12
nasian,25.3404237394,5.74907458247,1,1,2
therapture_,25.3258278266,5.13054155253,2,2,4
sunvulcan,25.3120077008,1.54430993674,21,19,40
salt,25.2941591503,4.96321040971,2,2,4
purple fox,25.2890644797,4.58709452422,2,2,4
wazzberry,25.2821512309,4.73421942984,2,2,4
cortese187,25.2734327832,4.80713072026,2,2,4
swiftbass,25.2622368269,4.89216411198,2,2,4
h2o,25.2593669871,4.85995252983,2,2,4
zhu,25.2570917719,5.15198224649,1,2,3
klms,25.2540556461,4.9265753216,2,2,4
leaf fc,25.2491521728,3.70987162073,4,4,8
zbl_mystic,25.2424725068,5.22739906805,1,2,3
pandemonium,25.220578387,4.55214797812,2,2,4
giraphe,25.1767537615,4.8547062007,2,2,4
wowzers,25.1586957156,4.68073409761,2,2,4
qubit,25.1257493202,4.91426923128,2,2,4
karlthemarx,25.1124033326,4.8206721687,2,2,4
tootmoses,25.1028855059,4.09885846633,3,4,7
leavescat,25.0993709433,3.5385561854,4,4,8
poptartplug,25.0826285291,5.11818158289,2,2,4
damp,25.0462356422,4.82420329543,2,2,4
notlightningrunner,25.0432425227,4.65308130371,2,2,4
measthebeast,25.0303484868,2.09060272041,9,10,19
tom bombadil,25.0252973917,3.27553404535,4,5,9
beguiler,25.0181002617,5.04179208223,2,2,4
village mascot,25.0025219874,2.22266769565,11,14,25
k-phat,25.0,8.33333333333,0,0,0
sambo,25.0,8.33333333333,0,0,0
baedough07,25.0,8.33333333333,0,0,0
neverpullout,25.0,8.33333333333,0,0,0
grunyan,25.0,8.33333333333,0,0,0
nokto,25.0,8.33333333333,0,0,0
spaff,25.0,8.33333333333,0,0,0
bedgar,25.0,8.33333333333,0,0,0
pat,25.0,8.33333333333,0,0,0
rudedude,25.0,8.33333333333,0,0,0
hyperbole,25.0,8.33333333333,0,0,0
esuma,25.0,8.33333333333,0,0,0
benb,25.0,8.33333333333,0,0,0
brentosfreshness,25.0,8.33333333333,0,0,0
stephanie,25.0,8.33333333333,0,0,0
djltheescapade,25.0,8.33333333333,0,0,0
acestarthe3rd,25.0,8.33333333333,0,0,0
magnus combosen,25.0,8.33333333333,0,0,0
pilot,25.0,8.33333333333,0,0,0
king lui,25.0,8.33333333333,0,0,0
l0n3r,25.0,8.33333333333,0,0,0
patty-wagon,25.0,8.33333333333,0,0,0
astumpycow,25.0,8.33333333333,0,0,0
tweli,25.0,8.33333333333,0,0,0
coldo,25.0,8.33333333333,0,0,0
deep dimples,25.0,8.33333333333,0,0,0
thac0,25.0,8.33333333333,0,0,0
chewy,25.0,8.33333333333,0,0,0
sylveonbae,25.0,8.33333333333,0,0,0
mouse,25.0,8.33333333333,0,0,0
monk,25.0,8.33333333333,0,0,0
moft,25.0,8.33333333333,0,0,0
duckpimp,25.0,8.33333333333,0,0,0
hail_sagan,25.0,8.33333333333,0,0,0
marfslayer 3000,25.0,8.33333333333,0,0,0
dr. light,25.0,8.33333333333,0,0,0
johnnyfight,25.0,8.33333333333,0,0,0
tdx,25.0,8.33333333333,0,0,0
jarl,25.0,8.33333333333,0,0,0
bund,25.0,8.33333333333,0,0,0
ferrero64,25.0,8.33333333333,0,0,0
god,25.0,8.33333333333,0,0,0
the cfb,25.0,8.33333333333,0,0,0
spade,25.0,8.33333333333,0,0,0
afro,25.0,8.33333333333,0,0,0
hypertj,25.0,8.33333333333,0,0,0
fireberts,25.0,8.33333333333,0,0,0
xbc30ep450,25.0,8.33333333333,0,0,0
the amazing busterino,25.0,8.33333333333,0,0,0
little bill,25.0,8.33333333333,0,0,0
awesomethesauce,25.0,8.33333333333,0,0,0
big d [hamiel],25.0,8.33333333333,0,0,0
bus,25.0,8.33333333333,0,0,0
ldz,25.0,8.33333333333,0,0,0
puddn,25.0,8.33333333333,0,0,0
mojn,25.0,8.33333333333,0,0,0
aperture,25.0,8.33333333333,0,0,0
scuttlebug jamboree,25.0,8.33333333333,0,0,0
sabo,25.0,8.33333333333,0,0,0
masterofzoroark,25.0,8.33333333333,0,0,0
4eyez95,25.0,8.33333333333,0,0,0
ubll black mage,25.0,8.33333333333,0,0,0
imperium,25.0,8.33333333333,0,0,0
royeric,25.0,8.33333333333,0,0,0
rice,25.0,8.33333333333,0,0,0
smashlopez64,25.0,8.33333333333,0,0,0
emon,25.0,8.33333333333,0,0,0
magitech,25.0,8.33333333333,0,0,0
nikku,25.0,8.33333333333,0,0,0
fenrir,25.0,8.33333333333,0,0,0
sussebass,25.0,8.33333333333,0,0,0
juno,25.0,8.33333333333,0,0,0
hans_mawell,25.0,8.33333333333,0,0,0
birdybirds,25.0,8.33333333333,0,0,0
yung,25.0,8.33333333333,0,0,0
astumpyzombie,25.0,8.33333333333,0,0,0
sharktoast,25.0,8.33333333333,0,0,0
mickeyrat,25.0,8.33333333333,0,0,0
mistertizye,25.0,8.33333333333,0,0,0
jeremy,25.0,8.33333333333,0,0,0
pvc,25.0,8.33333333333,0,0,0
name,25.0,8.33333333333,0,0,0
mahie,25.0,8.33333333333,0,0,0
bronze_sun,25.0,8.33333333333,0,0,0
spicky,25.0,8.33333333333,0,0,0
madguy,25.0,8.33333333333,0,0,0
goomah,25.0,8.33333333333,0,0,0
lunchy,25.0,8.33333333333,0,0,0
[stg] overload,25.0,8.33333333333,0,0,0
purplefox,25.0,8.33333333333,0,0,0
flash,25.0,8.33333333333,0,0,0
mimi,25.0,8.33333333333,0,0,0
voidstar,25.0,8.33333333333,0,0,0
werewyatt,25.0,8.33333333333,0,0,0
adubz,25.0,8.33333333333,0,0,0
redribb0n,25.0,8.33333333333,0,0,0
rf!,25.0,8.33333333333,0,0,0
lukem,25.0,8.33333333333,0,0,0
s≈çcrates,25.0,8.33333333333,0,0,0
locamash,25.0,8.33333333333,0,0,0
foxnard,25.0,8.33333333333,0,0,0
pastor,25.0,8.33333333333,0,0,0
miken,25.0,8.33333333333,0,0,0
filet,25.0,8.33333333333,0,0,0
sleeh,25.0,8.33333333333,0,0,0
dude,25.0,8.33333333333,0,0,0
chai,25.0,8.33333333333,0,0,0
brendanhall,25.0,8.33333333333,0,0,0
travkid,25.0,8.33333333333,0,0,0
snazzy,25.0,8.33333333333,0,0,0
tarn,25.0,8.33333333333,0,0,0
malkasaur,25.0,8.33333333333,0,0,0
shunkun,25.0,8.33333333333,0,0,0
fractal,25.0,8.33333333333,0,0,0
bulldog,25.0,8.33333333333,0,0,0
cr0ak,25.0,8.33333333333,0,0,0
squallette,25.0,8.33333333333,0,0,0
dunos_,25.0,8.33333333333,0,0,0
dobermen?,25.0,8.33333333333,0,0,0
oljace,25.0,8.33333333333,0,0,0
flat nat,25.0,8.33333333333,0,0,0
reb,25.0,8.33333333333,0,0,0
jobook,25.0,8.33333333333,0,0,0
k8,25.0,8.33333333333,0,0,0
urpasmash,25.0,8.33333333333,0,0,0
falln,25.0,8.33333333333,0,0,0
dezno,25.0,8.33333333333,0,0,0
refriedjeans,25.0,8.33333333333,0,0,0
bird-dawg,25.0,8.33333333333,0,0,0
karl,25.0,8.33333333333,0,0,0
da bear,25.0,8.33333333333,0,0,0
link,25.0,8.33333333333,0,0,0
phex,25.0,8.33333333333,0,0,0
redeagle2000,25.0,8.33333333333,0,0,0
core,25.0,8.33333333333,0,0,0
wolfcry,25.0,8.33333333333,0,0,0
paul d,25.0,8.33333333333,0,0,0
price,25.0,8.33333333333,0,0,0
sd master,25.0,8.33333333333,0,0,0
vio,25.0,8.33333333333,0,0,0
sheen,25.0,8.33333333333,0,0,0
zane,25.0,8.33333333333,0,0,0
levity,25.0,8.33333333333,0,0,0
4sk,25.0,8.33333333333,0,0,0
thomas,25.0,8.33333333333,0,0,0
branchan,25.0,8.33333333333,0,0,0
electricgazelle,25.0,8.33333333333,0,0,0
ozymandias,25.0,8.33333333333,0,0,0
sandman,24.9887255082,4.55877458215,3,2,5
iheartqueso,24.9748566271,2.63591767048,8,9,17
lou_sanus,24.9693837066,1.45722123456,21,24,45
imdabes,24.9544618082,4.9329171002,2,2,4
yass2queen,24.9521629583,5.55029356187,1,2,3
blisstex,24.934822043,2.97726055538,6,7,13
biz,24.917140739,3.49405264737,3,4,7
dr.yonz,24.9105932892,3.02118665779,4,4,8
pintoa,24.8843691435,2.52365851362,8,9,17
jc_chill,24.8816904935,4.66007647926,2,2,4
hayrow,24.8760716524,5.60963176016,1,2,3
shaddi,24.8700430239,2.72501809263,6,6,12
olikus,24.8259621088,4.48978920791,2,3,5
dasit mane,24.8054783952,5.29757846679,1,2,3
pidgezero_one,24.8030371179,4.92260328023,2,2,4
7blanks,24.7857655914,4.03426846924,3,3,6
vanillarin,24.7809754632,3.89355343093,3,4,7
yeye,24.7494207188,4.26845169723,2,4,6
tafokints,24.7481474278,5.98106833786,1,1,2
et,24.7136692847,1.87349220718,10,18,28
schmerka berl,24.6945115904,2.51958436199,7,11,18
alex,24.6851948775,3.92126377247,3,5,8
daddy's milk,24.6676852937,4.12856222723,3,4,7
blueman,24.658340659,4.14690832408,3,4,7
soulbroker,24.6490965711,4.77612071047,1,2,3
dankestdad,24.6437415848,3.67614204639,4,4,8
barron,24.6388741113,5.14153367566,2,2,4
tetsu0,24.6262993259,5.03796166079,2,2,4
drinkwildturkey,24.6183730465,3.37292813013,4,4,8
handles,24.6101306971,2.1096379422,10,11,21
dount,24.6060569127,4.09402006283,3,3,6
mmneggs,24.5976557766,3.37718265595,2,6,8
whuck,24.5828430357,4.01651529369,2,3,5
thissidedown,24.5513665815,5.43925573599,1,2,3
tmakk,24.5249790204,3.24617068526,5,6,11
aces,24.5073475022,2.62233184478,6,11,17
fanboy,24.4889711,5.72519963919,1,2,3
cashhole,24.4784241782,5.40867711415,1,2,3
collin the conqueror,24.4582480014,5.06356359914,2,2,4
satch,24.4484190474,5.04404046701,2,2,4
dusttin,24.43640721,2.20682781786,10,13,23
hotpocket,24.425794947,2.48041407326,8,10,18
pettanko-senpai,24.3979879756,2.65881219854,7,6,13
luigikid,24.3970096336,5.00145699011,2,2,4
jazzy jinx,24.3888989225,4.61063078292,2,2,4
chicken,24.3302488377,2.98041735151,5,7,12
tauvalian,24.3283622006,5.04985079081,2,2,4
reese,24.3021092979,4.43609296046,2,2,4
sombrero,24.2179958312,5.24435673891,1,2,3
esid,24.216779388,2.1428693485,10,9,19
monkey,24.199068297,2.03886073389,10,13,23
gamer4life,24.1936988112,4.62671965627,2,2,4
chevrium,24.1818347836,3.68843874009,3,4,7
enemajoe,24.1765979277,3.24401194622,4,4,8
moist,24.1742036403,4.99802031958,2,2,4
smashg0d,24.1473408161,5.37571815839,1,2,3
k-nut,24.1365368992,4.29427694186,2,3,5
drewgong,24.0419823544,1.78481553181,13,16,29
skrull,24.0382413029,4.94514045373,2,3,5
dsj,24.0278846432,2.66913721916,6,6,12
gaggleforce,24.0194562669,5.21379339102,1,2,3
pzero39,24.0098299462,2.10478457826,10,15,25
sunshinetk,23.9911996257,4.72938122836,2,3,5
jinjo,23.9700897429,5.5704973186,1,2,3
natural brother,23.9628944038,2.89846063364,5,8,13
kevine,23.9477325873,5.60074788092,1,2,3
costaricancool,23.9301440452,4.56037777054,2,3,5
nuggzy,23.9133660777,4.78267472168,2,2,4
ders,23.909641336,3.70415353056,5,4,9
savior,23.903488871,4.95466006915,2,2,4
wubbs,23.8759959579,4.93134931239,2,4,6
slippypickle,23.8584117238,4.26245649418,2,4,6
jaquarium,23.8404794066,5.04087719999,2,2,4
sk,23.8399438375,5.66738225185,1,2,3
cmac,23.8336364098,3.23975653279,4,6,10
camerino,23.8301051721,4.17609793355,2,4,6
khakis,23.8195168002,4.66275126303,2,3,5
dirtcruncher,23.8081199349,3.34521926927,4,6,10
monad,23.802308146,1.50760225004,17,31,48
waldo,23.7825553119,4.19578685754,2,3,5
grahamaglam,23.7539800891,1.98621825027,8,14,22
gaijilla,23.7335000994,5.89458141807,1,2,3
mr. biz,23.7210641953,5.05089869586,2,2,4
probers,23.6839741158,4.62700656,2,2,4
truffleshuffle,23.6788769285,4.52693030002,2,3,5
zenaga,23.6761009151,5.50042648943,1,2,3
icho,23.6501151844,4.88088743887,2,2,4
majin_bukkake,23.6311161087,1.94677856551,11,16,27
derstuk,23.6219011847,2.18801064544,10,12,22
puncayshun,23.6018890306,3.55955629482,4,3,7
papaghanoush,23.5782314643,3.54148797176,3,4,7
searing scar,23.5692916044,4.41092979572,2,4,6
wheels,23.5656092351,2.18455902893,8,7,15
kingkool,23.5466078061,2.49699019603,8,10,18
izoo,23.5371695413,5.42181231484,1,2,3
wal,23.5336824981,5.76636514869,1,2,3
b.i.,23.5208266588,1.95746188292,9,13,22
file,23.5066357297,2.60353316465,8,5,13
capos,23.4990849109,1.11938390514,43,54,97
chronicmexican,23.4746980238,2.45175793933,6,12,18
arctic,23.4684294881,5.40148296815,1,2,3
bre,23.4652606928,2.34417801363,7,9,16
staysleepin,23.4232290702,2.92030911794,4,8,12
sonicfuzz,23.4023800621,2.02609251074,12,15,27
moze,23.381054954,4.99312119924,1,2,3
pochilin,23.3686415636,3.89578154083,3,5,8
rawdog,23.363334365,5.06369679768,2,2,4
steamfriedasian,23.3621246951,5.73391255533,1,2,3
-philip coast philip-,23.3460507534,5.25167639573,1,2,3
thrillhouse,23.3057838905,1.8338785204,11,17,28
gera,23.2851911871,5.48739664317,1,2,3
sph,23.27614359,4.5186933381,2,3,5
byff,23.2569124815,4.54487217281,2,2,4
bhol,23.2557776458,2.26639348601,8,11,19
neth,23.1861020266,5.49320539377,1,2,3
qtip,23.1471201424,5.96320374501,1,1,2
dwreck,23.1427050378,5.50870913819,1,2,3
chino san,23.0985518383,5.41457051363,1,3,4
clefairy as mew,23.0927379524,4.95371121424,2,2,4
bottle opener guy,23.0623334097,3.3632243122,4,4,8
minymidge,23.0582682116,2.16290701675,7,16,23
weedlypuff,23.0497926541,3.21321945487,4,5,9
andy,23.0482093062,3.15720128097,3,6,9
masquerade,23.0480593414,5.50126583567,1,2,3
matt,23.0400078327,3.23625112187,3,5,8
ardent rage,23.0390518825,5.33053236201,1,2,3
bimbo,23.0232506364,2.94981015625,4,5,9
dex,23.011135291,7.26144247377,0,1,1
garv,23.0093845888,3.94328771045,2,2,4
billbacon420,23.0017191207,1.43232771178,20,31,51
gibbles,23.0004859097,4.98564418899,1,2,3
jaapoh,22.9986327816,3.6145414691,3,4,7
kman,22.9932321123,5.67901093998,1,2,3
bean,22.9719259187,1.75109043255,12,25,37
ditto,22.9316133782,2.34192364194,7,11,18
ajbcdefg,22.9270384914,1.44036757471,22,29,51
pluto,22.9092643073,5.56218526537,1,2,3
asaaj,22.8761325272,3.29574776304,4,4,8
nigel_thornberry,22.8525552656,5.24517339621,1,2,3
dankpank,22.841845787,1.36437979766,23,33,56
brny,22.835010313,5.26675091251,1,2,3
lordtoko,22.8347032513,2.75042913012,5,7,12
zibba,22.8170969194,7.24300767435,0,1,1
duncs,22.7745864674,1.56891429967,20,24,44
bflakes,22.7721813759,1.92370663523,11,16,27
greenblob,22.7628377485,2.93476436513,4,7,11
stylisland,22.7512670465,5.11681095085,1,2,3
bodacious,22.7456335897,4.10770698892,3,4,7
dsyr,22.743911162,4.00179307005,2,2,4
goosewithsocks,22.7245592956,1.56313784608,18,23,41
xanz,22.7216903438,5.09008313622,1,2,3
silver,22.7155338896,3.15025517285,4,6,10
bonerstorm,22.7131543348,5.03759629022,1,2,3
verwaltung,22.6867102224,5.67101579923,1,2,3
egg,22.6848235263,7.13555646269,0,1,1
drewskii55,22.6773296708,7.1998936357,0,1,1
crazyk115,22.675195546,5.13123091144,1,3,4
rgood,22.6568814078,5.22740397957,1,2,3
xif,22.6514029781,7.12491104683,0,1,1
nanagens,22.6283063838,2.84279721041,7,5,12
aisengobay,22.6281627487,5.02165362371,1,2,3
boh,22.6263883891,5.22409885802,1,2,3
cooljoe,22.6161343304,5.22917378086,1,2,3
foda,22.6042402192,1.9488159564,11,14,25
cyan can,22.6025690998,3.5702357126,3,6,9
hotahota,22.5847789248,2.72772698018,7,7,14
cuppajoe,22.5614711416,3.98912966001,3,4,7
evals,22.5497261156,5.26109394584,1,2,3
zhao_guang,22.5411975084,5.28343914226,1,2,3
robnu,22.5361970475,5.27291984814,1,3,4
schlag,22.5295736344,5.64093463869,1,2,3
momdameatloaf,22.5148788011,2.76307100096,5,6,11
keagsbsmashin,22.505682607,4.93161471885,2,2,4
lldl,22.4754387364,5.54602983821,1,2,3
bombproof,22.4703963028,3.14111638898,4,7,11
bohemian milk,22.4410234019,5.64191828862,1,2,3
mourin,22.436189438,5.53322447519,1,2,3
widdy,22.4350121625,1.77561839828,14,27,41
rythemretrn,22.4257927027,5.54390698698,1,2,3
okay,22.4189411067,5.79866055181,1,3,4
hsf,22.3577182729,5.21749074515,1,2,3
tokaji,22.3418384892,5.72549549374,1,2,3
the professor,22.3357851457,3.93517245049,3,5,8
panda,22.3339988684,2.8695400246,5,9,14
zergos,22.3298630085,3.28057675759,4,6,10
maaron,22.3235126558,5.2279102694,1,2,3
rebel scum,22.3120968499,3.35281578104,3,5,8
happens,22.3004129152,3.38167265092,3,5,8
yakal,22.2950630033,5.45881954507,1,2,3
milleneum,22.2790131309,2.66268067565,5,10,15
moonshoe,22.2764173668,1.22675673786,30,49,79
sun vulcan,22.2630109463,3.9758599453,2,4,6
mickeyo64,22.2583571706,5.07212029191,1,3,4
adrian,22.2449221962,5.4939042246,1,2,3
geekliftus,22.2334848055,5.51993490319,1,2,3
green eggs and spam,22.219780847,3.96510318124,2,4,6
train_town,22.2182491195,5.25970810876,1,2,3
ocelot,22.2091578768,2.14317546178,6,17,23
squible,22.2081746051,2.73972809789,6,7,13
hunter,22.1932669166,2.20632151729,7,11,18
prism,22.1846826736,5.77103200607,1,2,3
grrg,22.1692257944,2.56907025202,6,11,17
toez,22.1553695098,5.17921039978,1,2,3
cbones,22.1425979996,5.17784168517,1,2,3
chiefreaper,22.1151859141,5.33476205532,1,2,3
mr. tit,22.1060282393,2.54234551924,5,7,12
omar,22.0908900106,4.53068942298,2,4,6
giraffe,22.0832446758,5.52720444839,1,2,3
mrryanness,22.0394951328,3.72867142664,3,7,10
hotspank,22.0347069728,2.53675796815,6,12,18
hamburglar,22.0313772247,5.47262274073,1,2,3
hbrw-hammer,21.989450955,5.19683618143,1,2,3
mrpoo,21.9694395301,5.5090539933,1,2,3
banana fiend,21.9571408911,5.00477127102,1,2,3
zarc,21.9523180178,5.3661603852,1,2,3
han,21.8966597569,5.31977588561,1,2,3
kzidek,21.8867795024,5.53430238446,1,2,3
papasquat,21.8483424644,1.62574929901,12,27,39
sebson,21.769514896,4.86815673987,1,3,4
kristoff,21.7632348356,1.91205060931,12,19,31
kaddy,21.7448383797,6.97871477739,0,1,1
elated,21.7169123316,2.06335522068,9,16,25
pizzajokes,21.7162054905,5.50815225737,1,2,3
paco [larkin],21.7159475813,5.45508770932,1,2,3
fawnco,21.6867950646,5.49425252058,1,2,3
burnt out ninja,21.6867950646,5.49425252058,1,2,3
keatsta,21.6865525727,5.27399222741,1,2,3
cardoso,21.6780577038,5.47180539926,1,2,3
eggmcmuffin888,21.6479610644,2.48399319836,5,9,14
gumbolaya!,21.6434793433,5.28700972786,1,2,3
iceking,21.6196018458,2.74864743443,5,12,17
dax$,21.5961417248,2.65543597735,6,6,12
moonlight,21.5823932614,2.70267490485,4,9,13
yolochi,21.5811460291,2.39058168152,7,13,20
calzum,21.5715521788,5.33711999753,1,3,4
halffulla,21.5624875017,3.47701050385,3,5,8
macintosh,21.5418227396,3.43970829912,3,6,9
slartibartfast42,21.5328392932,4.28071789839,2,4,6
evab,21.5281310611,5.45654170068,1,2,3
ondas,21.5111827075,3.48818106101,3,5,8
zwephy,21.5047657545,5.52858492613,1,2,3
zombie!,21.5047657545,5.52858492613,1,2,3
anathema,21.5047657545,5.52858492613,1,2,3
kossismoss,21.5047657545,5.52858492613,1,2,3
jirachinick,21.5047657545,5.52858492613,1,2,3
trevman,21.5027061159,5.10402665286,1,2,3
weirdy man,21.4938394777,5.32664823819,1,2,3
xiivi,21.4884529761,2.8591552791,5,9,14
sadu,21.4831253742,5.56869670732,1,2,3
tipc,21.4650141252,2.90568702099,4,8,12
jmabate,21.4375021927,5.28753891929,1,2,3
gray,21.4357400409,2.66366394129,5,8,13
fearlesscaboos,21.4285257127,5.32500494842,1,2,3
v-bomber,21.4000216092,4.19284654502,2,4,6
jdp,21.3967152344,5.30318352811,1,2,3
elrond,21.3779780627,2.44993476709,6,13,19
whoopiecow,21.3422581477,5.51129103904,1,2,3
napkins,21.3422581477,5.51129103904,1,2,3
bubby,21.3396390978,5.35310713357,1,2,3
moustasher,21.3279703256,2.42949823462,7,12,19
boink,21.2783343204,3.33289856957,4,5,9
fish,21.2725190516,7.11048197228,0,1,1
pikasneeze,21.262221344,2.74884641243,5,6,11
frostbyte,21.2489088093,3.48045262062,3,7,10
minusev,21.228864937,7.0978953209,0,1,1
peaceful soujourner,21.1875935326,5.11338692949,1,2,3
dankey kang,21.1192659135,2.14918959414,7,17,24
doby,21.1094960334,4.84985745668,1,2,3
blue bear,21.1002964099,5.55587524657,1,2,3
catastrophe,21.0999787277,3.70866927686,3,4,7
kavon,21.070209472,5.51002169606,1,2,3
shasta,21.070209472,5.51002169606,1,2,3
mizbiz,21.0618343139,3.26570642075,4,4,8
hungrybox,21.0458327936,4.48872068442,2,4,6
static,21.0420378383,3.56926567234,3,5,8
fingerblast,21.0282940861,4.56717238675,2,2,4
kosher,20.9929639317,3.1167981316,3,6,9
zach777,20.9758957529,6.49438878737,0,2,2
dair,20.9304814119,3.28124278897,4,4,8
dr combos,20.9228539424,3.28658340791,2,8,10
h00n,20.9224163134,3.73839070873,2,4,6
zerobombjake,20.9062441537,3.22873419728,4,6,10
fuzzyness,20.8785228451,5.24584273634,1,3,4
apparition the ambassador,20.8721477529,1.20656052024,25,55,80
tallboi,20.8640212355,6.62008337421,0,1,1
java boy,20.8573962319,5.51420898734,1,2,3
yungpurp,20.8494147883,6.68210388938,0,1,1
seantos,20.848990415,1.94281559538,11,23,34
big tone,20.8406120534,7.05844745916,0,1,1
lucky_hamburger,20.8372533508,2.95380575917,4,7,11
ttp,20.8053566702,3.45088732913,3,6,9
zad,20.8037023428,3.38007051069,3,7,10
eliot,20.800150921,4.9216372622,1,5,6
fork?,20.7717046064,4.93526830127,1,3,4
buttery adachi,20.7705461357,4.64434841954,1,3,4
mojo,20.7589379883,5.1984974191,1,2,3
lalo,20.7423750734,4.13893185685,2,4,6
joel,20.6824544877,2.7831192558,5,8,13
zouzy,20.6755344261,5.54532760265,1,2,3
hipo,20.6704005576,5.21848248582,1,2,3
brotherly,20.6628320352,2.7551006498,4,7,11
icactusdog,20.6066626615,1.1644894895,31,76,107
lonk,20.60416798,7.17147558733,0,1,1
josiab,20.60416798,7.17147558733,0,1,1
sfat,20.60416798,7.17147558733,0,1,1
akito555,20.60416798,7.17147558733,0,1,1
benbook,20.60416798,7.17147558733,0,1,1
4 phri,20.60416798,7.17147558733,0,1,1
k-man,20.60416798,7.17147558733,0,1,1
phalanx,20.60416798,7.17147558733,0,1,1
nannose,20.60416798,7.17147558733,0,1,1
captain murphy,20.60416798,7.17147558733,0,1,1
kayo,20.60416798,7.17147558733,0,1,1
5000candlesinthewind,20.60416798,7.17147558733,0,1,1
silent skyler,20.60416798,7.17147558733,0,1,1
jad,20.60416798,7.17147558733,0,1,1
bunmira,20.60416798,7.17147558733,0,1,1
nyani,20.60416798,7.17147558733,0,1,1
sherb,20.60416798,7.17147558733,0,1,1
yung god,20.60416798,7.17147558733,0,1,1
changed man,20.60416798,7.17147558733,0,1,1
nfreak,20.60416798,7.17147558733,0,1,1
mystery,20.60416798,7.17147558733,0,1,1
fs shampoomaster,20.60416798,7.17147558733,0,1,1
akajumo,20.60416798,7.17147558733,0,1,1
drewjames,20.60416798,7.17147558733,0,1,1
ragingcherry,20.60416798,7.17147558733,0,1,1
thissideup,20.60416798,7.17147558733,0,1,1
penance,20.60416798,7.17147558733,0,1,1
uprowr,20.60416798,7.17147558733,0,1,1
queso,20.5938675286,2.82586942064,3,8,11
jaws,20.5676658066,5.35482917924,1,2,3
howdy,20.5621945112,2.12177858029,11,14,25
nuro,20.5389518189,5.43185785249,1,2,3
goose,20.5381004106,3.84680463129,2,4,6
flatline,20.5164882806,5.24452888369,1,2,3
thenuge,20.5013392426,5.04003806029,1,3,4
three beers,20.4864488732,2.70037052845,4,8,12
heartsdealer,20.4405992168,4.22373191901,2,4,6
papa,20.4368071139,3.07903498777,4,8,12
voff3,20.3954522573,6.99340631441,0,2,2
throwz?!,20.3712942976,5.17095113297,1,2,3
barrels,20.3686059834,3.85809326249,2,6,8
cormander,20.3671792595,2.70549245154,4,12,16
homemadewaffles,20.3612733202,6.92690169084,0,1,1
mr baninawi,20.3193599258,4.50670802383,1,2,3
e-jager,20.3112331877,4.96609717388,1,3,4
hero,20.3003305973,6.88831159169,0,1,1
acerunner,20.2791530108,3.8296372684,2,5,7
spunker,20.2783887162,6.64193201717,0,2,2
caelan,20.204195046,7.0610632401,0,1,1
mighty afro dighty,20.1766830718,3.72533783466,2,4,6
butcher of bakersfiefox,20.1709924669,3.98886789201,2,5,7
mikeyp,20.1546766565,2.6442099622,5,10,15
jag,20.1508482414,3.02776670637,4,8,12
fritz wethermyb,20.1292589917,6.19812821843,0,2,2
teflon ron,20.1058591064,3.33133048757,2,6,8
izze,20.0863911483,4.69116917934,1,4,5
mjim,20.0813010407,2.73916736329,4,12,16
bawdbabe87,20.0502255424,2.97317062259,5,8,13
aegeze,20.0287605698,3.37746389472,3,5,8
shug,20.022873977,3.29291014853,3,8,11
accru fenix,20.0135942176,2.89852022381,3,10,13
nich,20.0005674341,3.23953012933,3,10,13
b vu,19.9779918419,6.56462785713,0,1,1
depressed eagle,19.9668557046,4.71517261952,1,3,4
weatherman,19.9361842857,6.05438025427,0,3,3
tallyshell,19.9342139881,5.03744670312,1,2,3
takuto,19.9209084134,3.46619705091,3,4,7
pokmo,19.9076884681,2.97926838448,3,8,11
kiwi,19.9053859173,3.21174045045,2,7,9
stark,19.9047519543,2.12771740138,7,15,22
maximum can,19.8807968822,6.1968182466,0,2,2
pika,19.8665160974,4.50476058035,1,4,5
frogman [charette],19.8470685379,6.53515646093,0,2,2
rogue1wasjustok,19.8460277552,2.87387545529,3,8,11
nineball,19.8416605525,3.00393733899,3,7,10
multiball,19.822537571,2.18431568197,8,16,24
danny,19.8132004678,6.8317061207,0,1,1
king robin,19.8128673226,5.18519924189,1,3,4
spt,19.8025232552,6.38548140082,0,2,2
catlover321,19.7771299233,4.63158307508,1,2,3
dad's musical erasers,19.7703658544,6.34330364497,0,2,2
mikelangelo,19.7461948385,6.43727618769,0,2,2
cagt,19.7181299667,1.63475125507,16,27,43
sebastian,19.6713439106,2.92413856197,4,8,12
muse,19.5709409146,2.1715267887,8,14,22
fiasko,19.5056927057,4.80812176512,1,3,4
yaron,19.457187768,3.69052851875,1,6,7
danno,19.4480883685,5.26348120732,1,2,3
dimension,19.4061385287,6.20651346822,0,2,2
diveo,19.3908039942,2.23379496863,6,18,24
qerbstomp,19.383509582,3.2102983718,3,10,13
tangerine,19.3635581904,2.76022630534,5,10,15
magic,19.3606726138,3.14653584819,3,5,8
fred,19.3512733707,4.82054371145,1,4,5
fumofuu,19.3003820949,6.70094005858,0,1,1
veen,19.2649590252,6.50769593739,0,1,1
houndour,19.2326852327,4.73127945306,1,5,6
missingn0,19.1950717181,6.10648839204,0,2,2
russellsprouts,19.180792943,1.27510885595,24,69,93
bluebear,19.179392368,2.68355742564,5,10,15
krypto,19.1590647171,4.80958059903,1,4,5
jive turkey,19.1559650076,4.30320562929,1,4,5
husker,19.1404494768,4.23587159018,1,5,6
laugh,19.1292544053,2.80656115093,4,10,14
bleachfanboy4life,19.078737477,5.04776930726,1,3,4
rush,19.0591258663,2.84964553153,3,9,12
brown_omega253,19.0495734057,6.32975483504,0,2,2
k,19.0428343177,5.95249011755,0,2,2
slatts,19.0259160117,1.76512232463,10,27,37
supernuggit,19.0099577743,2.47450245584,5,12,17
esmod,19.004211349,6.50799591405,0,2,2
fs mook,19.0028728103,6.87267909617,0,1,1
skubtard,19.0028728103,6.87267909617,0,1,1
jiffypop23,18.994704188,3.36242731783,3,6,9
rabizkoshik,18.9387563269,4.96521521123,1,4,5
kingcool,18.9351088349,3.64474619053,2,6,8
guccipivotmaster4000,18.9347382351,6.43705129894,0,2,2
dixoncider,18.9240393398,2.98147964176,4,9,13
ego,18.9220364506,6.43080985891,0,2,2
precookedbread,18.9052180392,6.13144583345,0,2,2
ensindic,18.8827729509,2.85661652038,4,11,15
engdrew,18.8784411978,2.71490294375,3,9,12
dcmaster,18.876508094,3.3085934222,3,6,9
luwolf,18.8484820941,6.29597085244,0,2,2
neat,18.8456748403,2.46234672333,4,17,21
quentendo,18.8279766945,6.15863924846,0,3,3
muthalova7,18.7959393642,3.29716978728,4,5,9
blizz,18.7928519856,6.79635578797,0,1,1
turtlpower,18.7895018776,6.35251859374,0,2,2
littlespoon,18.7797815395,6.3597378531,0,2,2
bananabolts,18.7763350487,4.13018873364,1,5,6
mr.e [rohr],18.7703709704,6.52341434227,0,2,2
flare,18.7468013789,4.81885704566,1,4,5
iacme,18.7005700184,5.87207445275,0,2,2
duck chris,18.6843486974,6.48895532793,0,2,2
fen,18.6651960945,4.60992013254,1,4,5
wilbur,18.6623371943,6.48063769489,0,2,2
jgin,18.6321608332,5.92034936976,0,2,2
nathansandwich,18.6193151803,3.37456404206,3,7,10
kieuarty,18.611156125,6.46321841715,0,2,2
youtwo,18.6056078068,6.49184921396,0,2,2
kl3an,18.5588529466,6.38820575423,0,2,2
r.o.m.,18.5588529466,6.38820575423,0,2,2
pokeiman_master,18.5516219727,6.44406310517,0,2,2
tdp,18.5322048421,6.27670782881,0,2,2
lecceo,18.5224563478,6.04122538682,0,2,2
crazy_cubano,18.5151554525,3.25770690385,3,6,9
failcant,18.5036619979,6.53954925511,0,1,1
ender,18.4910837713,3.08584327164,5,6,11
ltdan,18.4774283024,4.29996109175,1,4,5
tbone,18.4739919389,6.26372813517,0,2,2
nagurnimaster,18.4700890997,6.22509745584,0,2,2
superkirby,18.4611593024,6.07126152759,0,2,2
pugdaddyfre$hlyfeogg*flva,18.4491791431,6.2655689814,0,2,2
dance!!,18.4455282261,4.27626235146,1,5,6
reno,18.4423554089,5.79143124447,0,2,2
myninja,18.4400545942,4.38110947843,1,4,5
professortoke,18.4277689873,6.40598472915,0,2,2
cracker jones,18.4269283316,1.80020480062,9,28,37
swerve,18.3924240113,6.39631598175,0,2,2
stdangerous,18.3869320511,6.13518467314,0,2,2
big d squirrels,18.3845697491,6.3955012082,0,2,2
master jay,18.3609401588,6.39052231831,0,2,2
shwang,18.3577767565,6.2521714548,0,2,2
nami,18.3449675847,6.12168390994,0,2,2
hasme,18.3361849291,5.59943655815,0,3,3
charlie harper,18.3330999134,6.38313840111,0,2,2
silky johnson,18.3135237707,3.28385734391,2,8,10
oxycontin,18.3049578438,4.56472838053,1,4,5
mntd,18.303113454,3.37281444427,2,7,9
blackf00t,18.2957405055,6.11791947838,0,3,3
quinceprince,18.2944270184,6.23604937648,0,2,2
arcangel,18.2768027619,4.27160597006,1,5,6
vidya_james,18.2599735641,4.54150810607,1,4,5
jesusisking,18.2425746549,6.14038984196,0,2,2
tangpootie,18.2274308019,2.52490433641,5,12,17
tubby!,18.2040109858,6.13274902419,0,2,2
blues,18.1874960602,4.80990360288,1,4,5
xlax,18.1874527175,4.71791538095,1,4,5
chi-fence,18.1568720068,4.40201871743,1,4,5
shawarma habibi,18.1455497317,3.43282352434,2,6,8
elmustachio,18.1178019254,6.11091424803,0,2,2
polarbair,18.1097156232,3.42939530138,3,6,9
jdeezel,18.096134607,6.31705839702,0,2,2
tylenol jones,18.0758497583,6.32077271178,0,2,2
avian,18.0712867461,6.31842389736,0,2,2
g-rabbit,18.0664165454,2.54499453471,5,12,17
erk,18.0475218268,6.31009962984,0,2,2
sweaters,18.0428187692,6.46387437135,0,2,2
warmachine1919,18.0428187692,6.46387437135,0,2,2
firefly,17.9980023599,6.32119878345,0,2,2
astropancakes,17.9980023599,6.32119878345,0,2,2
jpoptosis,17.9980023599,6.32119878345,0,2,2
drhino,17.9980023599,6.32119878345,0,2,2
snack?,17.9980023599,6.32119878345,0,2,2
yam$,17.9980023599,6.32119878345,0,2,2
albinosaurus,17.9829924851,6.07981880581,0,2,2
lights,17.9722012086,6.29535962389,0,2,2
beaver,17.9564848443,6.3115571796,0,2,2
armagreggon,17.9499444627,3.49502315217,2,5,7
elu,17.9435993432,2.86642692927,4,12,16
frame,17.9192885317,2.38260844235,4,19,23
trogdorbad,17.8916892145,4.88830406138,1,2,3
ccm,17.8745826413,4.06514957438,1,6,7
ebay,17.8407852112,6.26851580688,0,2,2
espparadox,17.8288827687,1.65937350637,11,33,44
bc_burns,17.8270005524,6.29388615473,0,2,2
legoman,17.8270005524,6.29388615473,0,2,2
dhir,17.8270005524,6.29388615473,0,2,2
mulkster,17.8270005524,6.29388615473,0,2,2
dennysgrandslambreakfast,17.8270005524,6.29388615473,0,2,2
jfm,17.8270005524,6.29388615473,0,2,2
armor,17.8270005524,6.29388615473,0,2,2
chaos pro,17.8270005524,6.29388615473,0,2,2
akiva,17.8270005524,6.29388615473,0,2,2
pajhomas,17.7983797115,4.27763174311,1,4,5
massimo,17.7929138053,5.80630293942,0,3,3
austntatious,17.7829509186,6.06931121416,0,2,2
aerodet,17.7626693932,6.38009936753,0,2,2
nadamoor,17.7571849257,6.26686880382,0,2,2
tehz,17.7493460665,3.38945058277,2,8,10
√°1,17.7340539792,2.61336603351,2,11,13
brambramjam,17.7281304498,6.03039661814,0,2,2
frogge,17.7193296658,5.91111489472,0,2,2
jackmehoff,17.7135963077,5.86190286565,0,2,2
jello,17.7095215142,3.25167977679,2,11,13
charlie,17.7006913652,6.02158775086,0,2,2
broonz,17.6679124769,2.08446973727,7,20,27
liam_butler,17.6673384456,6.26628461383,0,2,2
matt47,17.6673384456,6.26628461383,0,2,2
colt,17.6613529856,6.33021997137,0,2,2
 ô·¥è·¥Ö·¥Ä·¥Ñ…™·¥è·¥ús,17.6441979245,3.89311799681,1,6,7
luka,17.6235772842,3.73611471806,2,6,8
maxi,17.6227902384,6.22931743478,0,2,2
whitegrizzly,17.6211632096,6.0044317998,0,2,2
pigwick,17.6145656845,5.7986697379,0,2,2
scootieloo,17.6025155386,5.99030365635,0,2,2
the drew,17.5873457989,2.44619266681,4,16,20
general1712,17.5779881362,5.47693709977,0,4,4
jollie,17.5775446632,1.68897777033,11,34,45
coolguy76,17.5694102318,3.39920605546,2,6,8
leet,17.565059126,4.21694014824,1,6,7
bozz,17.559839839,6.18922189329,0,2,2
blank,17.5269841039,5.98245346039,0,2,2
rodan,17.5167074005,5.80608254359,0,2,2
sugaaku,17.4794969622,2.50323226486,5,14,19
gambit,17.4724485757,6.03130753421,0,2,2
maestro,17.4681984749,6.2394819151,0,2,2
chinstrap,17.4649334833,4.56998857617,1,4,5
mechanicalmarine,17.4524072942,6.30688568514,0,2,2
scraggus,17.4207899857,6.18548881364,0,2,2
ponkapa,17.3999317945,4.13074963603,1,8,9
capsui,17.3731396385,4.1858083512,1,7,8
cennis91,17.3546187838,3.61288889595,1,11,12
jonnjonn,17.3460543764,1.60861807016,11,37,48
hollow,17.3436367437,5.19126594071,0,3,3
sad,17.3097710331,6.27674314988,0,2,2
spammalanche,17.294751697,5.7688928998,0,2,2
harmless,17.2905728248,6.22322606387,0,2,2
mikeyg,17.2894835768,5.66175718426,0,2,2
highlyeducational,17.2602278329,6.07035824737,0,2,2
beets,17.2574844776,5.62221721859,0,2,2
louieg,17.2302184826,5.92760188249,0,2,2
juan doe,17.2249232193,6.2595773321,0,2,2
caprigon,17.1899055257,5.86001353942,0,4,4
spell,17.1870334967,3.41652672785,2,7,9
iamlazee,17.185740056,5.94441200211,0,2,2
lv20ninja,17.1775697227,3.22931541541,3,7,10
ohhhbreezy,17.1645697169,4.37309275394,1,4,5
holosly,17.1573329149,6.26923433457,0,2,2
ppdmd,17.1573329149,6.26923433457,0,2,2
jgly,17.1450682608,4.24204546288,1,4,5
superflopp,17.1426451539,2.65180659218,3,9,12
kraken,17.1398541025,6.28212270869,0,1,1
sunkin,17.1391075866,6.24032360265,0,2,2
master j.j.,17.1358355436,6.24039459921,0,2,2
starcutter,17.1011463592,6.0665411989,0,2,2
driftintheabyss,17.1009098272,6.2415552758,0,2,2
amaya,17.0988004859,6.241919664,0,2,2
dinner,17.0933637711,6.08039702859,0,3,3
beech,17.0889247577,3.3529813158,1,12,13
sam,17.0659865662,5.90317544352,0,2,2
pale,17.0566680133,3.43009763019,2,6,8
zarfon,17.0353081779,6.09705358847,0,2,2
hotsauce,17.0316574514,2.9381958554,3,8,11
ravioli,17.0284430048,6.30597887962,0,2,2
mr_sharpie93,17.021854216,6.22090893961,0,2,2
second boss,17.0208007029,4.80115693212,1,2,3
black rob,16.9946507075,6.21682728317,0,2,2
drlight,16.9870335546,5.93536565379,0,2,2
kastakatter,16.9668031539,5.65212499996,0,4,4
myroknpancakes,16.9641233841,3.33379219424,2,8,10
sianvar,16.9633446681,6.49717447875,0,1,1
giggitoxin,16.9572689606,6.19807969429,0,2,2
mattatari,16.9471739764,4.44514582762,1,5,6
miles,16.9273178368,6.23983584333,0,2,2
themickeynick,16.9273178368,6.23983584333,0,2,2
aubfox,16.9273178368,6.23983584333,0,2,2
riseup93,16.9273178368,6.23983584333,0,2,2
heisenberg,16.9273178368,6.23983584333,0,2,2
raxcity,16.9273178368,6.23983584333,0,2,2
beekle,16.9273178368,6.23983584333,0,2,2
d-tek,16.9273178368,6.23983584333,0,2,2
yuxminato,16.9273178368,6.23983584333,0,2,2
dinkleberg,16.9273178368,6.23983584333,0,2,2
dd,16.9273178368,6.23983584333,0,2,2
deku,16.9273178368,6.23983584333,0,2,2
searcher,16.9273178368,6.23983584333,0,2,2
irish,16.9273178368,6.23983584333,0,2,2
edwin...,16.9273178368,6.23983584333,0,2,2
umi,16.9273178368,6.23983584333,0,2,2
j,16.9273178368,6.23983584333,0,2,2
jazz,16.9273178368,6.23983584333,0,2,2
zurdo,16.9273178368,6.23983584333,0,2,2
abc,16.9273178368,6.23983584333,0,2,2
tuna,16.9273178368,6.23983584333,0,2,2
waffles,16.9273178368,6.23983584333,0,2,2
sfgman,16.9273178368,6.23983584333,0,2,2
15(ichigo),16.9273178368,6.23983584333,0,2,2
zombieheart84,16.9273178368,6.23983584333,0,2,2
paper tiger,16.9273178368,6.23983584333,0,2,2
qk shkz,16.9273178368,6.23983584333,0,2,2
red,16.9273178368,6.23983584333,0,2,2
sunshine,16.9273178368,6.23983584333,0,2,2
azzy,16.9273178368,6.23983584333,0,2,2
muthaluva777,16.9273178368,6.23983584333,0,2,2
sambook,16.9273178368,6.23983584333,0,2,2
digital cannon,16.9273178368,6.23983584333,0,2,2
uh what,16.9273178368,6.23983584333,0,2,2
draxsel,16.9273178368,6.23983584333,0,2,2
gaymer,16.9273178368,6.23983584333,0,2,2
grraffe,16.9273178368,6.23983584333,0,2,2
shadow light master,16.9273178368,6.23983584333,0,2,2
rickter_scale,16.9273178368,6.23983584333,0,2,2
theycallmechris,16.9273178368,6.23983584333,0,2,2
bearrimshot,16.8971445134,5.10260509064,0,3,3
jojohnson,16.8847446083,5.91443560749,0,2,2
dexter,16.843914172,5.72189736816,0,3,3
krutchby,16.8366823264,6.18674458762,0,2,2
shyguyking,16.8278588736,5.63034924809,0,2,2
babycakes,16.8232467393,3.37994671051,2,6,8
bunnyblast,16.8164815237,6.1927063121,0,2,2
kohenbro,16.8078355606,5.51238629639,0,4,4
castaway,16.8048785331,6.06752345676,0,2,2
vex kasrani,16.7925870415,3.47022359047,2,9,11
m2cain,16.7880607121,6.19335774512,0,2,2
sabe,16.7872661752,3.20372559238,1,7,8
mookie,16.7790762933,6.17549228699,0,2,2
comb,16.7786122304,3.52237584741,2,7,9
superduperfanofboom,16.7666227916,6.17256403512,0,2,2
robslabgod,16.7628618487,5.72732565238,0,2,2
halqery,16.7624061579,5.26738935133,0,4,4
keychain,16.7119309939,3.82971217665,2,4,6
saltking,16.6979724524,5.18354848213,0,4,4
jungle,16.6897994167,4.85280119083,0,7,7
jerzilla,16.6612408912,6.01798349036,0,2,2
rockmix,16.6400362269,5.94252713158,0,2,2
rollock,16.6193320332,5.42701504334,0,3,3
silentknight,16.609691351,4.36384328756,1,6,7
sven stormbeard,16.603680648,3.56580929197,2,6,8
chibama,16.6017912352,4.24151838596,1,4,5
scott,16.5972710002,6.15290821858,0,2,2
atari,16.5755046187,2.47567523903,5,15,20
falker,16.5687894641,3.30930978521,3,7,10
jpeghero,16.5542790113,5.72001128222,0,3,3
madara,16.5378394748,5.28471347066,0,4,4
lunarnova,16.5206176974,2.03679643818,6,32,38
instacover,16.5173598147,6.03304199256,0,2,2
ejmp,16.4965744596,6.14530357824,0,1,1
dmolz,16.4944034609,4.97088534466,0,4,4
curiousplaces,16.4686400239,5.98022918707,0,2,2
jedipanda,16.4647915137,4.78519132867,0,5,5
nnaughtydogg,16.3737904301,5.12906693269,0,4,4
bogmyer,16.3677235569,5.87555636419,0,3,3
magfmur,16.3354417012,5.811464978,0,2,2
nuggz,16.2907028246,3.6119167684,2,10,12
recneps,16.26011104,4.30110440634,1,6,7
dr gibs,16.2021899007,5.23131951349,0,4,4
duma,16.1469537228,3.63755887425,1,8,9
thegoat,16.1110336081,6.0577218926,0,2,2
rocktimus crime,16.0992903732,4.77460142995,0,5,5
lord horatio,16.093615499,5.55935586099,0,4,4
bill,16.0750122167,3.87757384527,1,6,7
scruffy mcwonder crumpet,16.0521404804,3.29953881064,3,7,10
i use tap jump,16.0501279339,3.71874589722,1,6,7
jedisalazar,16.0199757813,5.71550570122,0,2,2
frog,15.9915117615,4.49461787143,1,4,5
bluey,15.9671778343,5.36520140219,0,4,4
bennypuff,15.9422294148,3.52877880072,2,7,9
elitescoringguy,15.9182739587,2.56369639576,3,14,17
redwolf,15.8831330222,5.97846405882,0,2,2
eclipse,15.8825013823,5.18341085007,0,4,4
noelkitten,15.8731505615,5.65452520089,0,2,2
mrkymrk,15.8693841116,4.78413260397,0,5,5
yolft,15.8582970755,2.41370867893,2,21,23
12ties,15.848827938,3.47913045418,1,5,6
turquoise,15.842389832,3.27472753127,2,7,9
thedarkdreamer,15.802391653,6.01484204148,0,2,2
lampyshade,15.7860033208,5.40854333875,0,4,4
codytappen,15.7853216507,5.6088576584,0,2,2
jackkenney,15.7585225492,5.64899828726,0,2,2
twunt,15.745812513,2.91124025574,2,13,15
blahguy,15.7454563257,5.81008494948,0,2,2
lloyd-black,15.7316993222,3.58247607771,1,8,9
vondo,15.7240700032,4.72021122034,0,5,5
don,15.7143094481,3.55966381718,2,5,7
2%gay,15.7112175126,4.06997057092,1,8,9
spaz,15.6903232436,4.19007207759,1,4,5
norwayray,15.6817472282,5.25362337732,0,2,2
dk dredd,15.6475640437,5.91830761396,0,2,2
mm720,15.6459947778,5.58336375981,0,4,4
uncle onion,15.5522960143,5.93876560258,0,2,2
kobra,15.5368989787,3.16633562922,2,11,13
katiebug (sfk),15.5257668944,5.60340187496,0,2,2
lvl99wizard,15.5252822161,5.49432558559,0,4,4
tydye,15.4962095478,5.71435404844,0,2,2
bennyboy98,15.4862446417,5.96174045904,0,2,2
fmaj7,15.423759452,3.88382985368,1,6,7
shimshamlando,15.4109261851,2.31091333747,4,28,32
lou sanus,15.3809767544,4.5666113781,0,6,6
t-bone,15.3744330909,3.41381729575,2,6,8
mzadeh,15.3333157499,5.21056183615,0,4,4
peacemaker,15.2571670635,4.43201797978,0,6,6
kezzup,15.2424370236,3.6442111579,1,8,9
tanuki,15.2414745664,5.77050178339,0,2,2
tron,15.2085769661,5.6063436517,0,4,4
mariokartmoney,15.2023991933,5.46979181665,0,4,4
vnko,15.199945416,4.14664931598,1,4,5
ir,15.1932448581,3.90184945861,1,6,7
godspeed,15.1675586068,4.06536906148,1,7,8
dude wut,15.145391093,4.51138262887,1,4,5
bagel,15.1356957542,5.1963265951,0,4,4
thisisgettingofox,15.115537955,5.93072884891,0,2,2
bung0o,15.0861921012,5.20344175089,0,4,4
warhorse,15.062577536,3.76852377866,1,6,7
zbomber,15.0479932055,4.94080865175,0,4,4
rumi1819,15.035374572,5.25274083262,0,4,4
fry,15.0351272105,2.93336231092,2,13,15
dyo,14.9854496031,3.54206814226,2,6,8
dr-wumbo,14.9839655426,5.50492602216,0,2,2
bchill,14.9405175648,3.23960606966,2,7,9
ceephax,14.8595237801,5.78946898394,0,2,2
hufff,14.8500331311,3.63082613386,1,6,7
captainpugh,14.8456790866,5.52871586345,0,4,4
fig,14.8379883515,5.44294090835,0,4,4
adulix,14.7935449934,4.99541774313,0,5,5
swankeaboo,14.7929347903,4.63626962943,0,6,6
wiseacre,14.7728326742,3.64643637532,1,11,12
meccs,14.7104231534,5.02312393629,0,5,5
cnasty613,14.6918491937,3.48865130063,2,6,8
snoosnoo,14.6672311201,4.23921564702,1,4,5
feartheday,14.6561246857,2.88675017859,1,18,19
kevorkian,14.617831432,2.82642217508,3,13,16
showtime,14.5887361904,5.82355811529,0,2,2
bear,14.5885031086,5.31724245585,0,4,4
drunkn smash,14.5553413691,4.5069762278,0,5,5
goofinhiemer,14.5196610959,4.98947050862,0,4,4
midgetto,14.5045184064,2.31171231144,4,18,22
fmax,14.4895155373,5.50407742618,0,4,4
marfthekid,14.4828023056,5.52900805564,0,4,4
godofgrunts,14.4568644066,4.83052875559,0,7,7
yaks,14.4275562521,3.69214990311,1,8,9
hiddenmi$t,14.356806087,4.9376731979,0,4,4
cag,14.3368913197,5.13462413617,0,4,4
armadillo,14.3366953204,4.55708901711,0,6,6
ngwn,14.3329866298,3.40021935391,1,9,10
ryden hope,14.2910190469,5.6998136168,0,2,2
sevshun,14.2490536194,3.41175466737,1,9,10
auggie,14.2408844683,4.08036770126,0,9,9
usvn,14.2378726891,3.37594093215,1,11,12
rhubarb,14.2356785915,2.40277778599,3,18,21
cgmontage,14.1990695319,4.15806405497,0,7,7
spaghetti,14.1731559147,3.01576874332,1,11,12
fj20,14.1158383445,3.17404449225,2,7,9
chacalaca88,14.0406863999,4.49846259993,0,6,6
primefry,14.0273186407,3.05651074162,1,11,12
hiv+,13.8900795122,3.40049552191,1,8,9
myk,13.8626267077,5.36647171848,0,4,4
edgar allen pwn,13.8546749393,3.61867006931,1,10,11
oquinn,13.8476921468,4.40157389812,1,4,5
telemonic,13.8475875687,5.11308153552,0,4,4
chibaco,13.8350134679,4.21909621162,0,8,8
road-rage 64,13.7963224897,4.50144447781,0,6,6
bort,13.7949171949,4.0742311312,0,6,6
frapple_apple,13.7764249254,3.5206457333,1,7,8
turtle,13.775051629,4.39769125353,0,8,8
mf space,13.7279337972,4.73438073778,0,5,5
rich,13.7007160926,4.94211244526,0,5,5
kronk!,13.6596576378,2.64246923596,2,18,20
scruff,13.6055944774,4.97173646548,0,6,6
mattc,13.6001229853,4.33388079807,0,5,5
lotionhole,13.5940310436,4.41734362964,0,6,6
mike4real,13.5783571779,3.33405862886,2,10,12
bluntsmokinganusdestroyer,13.5613351832,5.34947970777,0,4,4
cat,13.5100554597,4.71980783012,0,5,5
hashi,13.5088198211,2.43857771654,3,22,25
whiz kid,13.4212074591,5.16852123362,0,4,4
blanco mano,13.4015177081,4.59893174621,0,5,5
ben,13.3842128479,2.55511209382,2,16,18
scaryman,13.3668329574,4.32703399476,0,6,6
heavy,13.3647251117,4.15885279033,0,5,5
hwatts,13.3159182176,3.61560827135,0,13,13
mop,13.2463572441,3.28511816255,1,8,9
woof,13.2208606529,5.01298816141,0,5,5
dabs?,13.185248993,4.09535051259,0,9,9
rokd,13.1231396074,4.70974374143,0,4,4
gato,13.1147609649,4.44171493252,0,5,5
neff,13.0941550192,5.55767096248,0,3,3
greatwhitebuffalo,13.0569837475,4.6683462285,0,3,3
sour,13.0463032601,3.75893841647,0,10,10
oldiz,12.9584536241,5.08223751624,0,4,4
weslec,12.9262111692,3.75323794875,0,8,8
brother quang,12.9070882597,3.33600814342,2,8,10
lotus,12.9001483062,5.47736935171,0,2,2
zorro253,12.894477315,3.25375326769,1,10,11
monica,12.8133167623,4.5803659133,0,5,5
boogie!,12.7755107362,3.015583867,1,14,15
nardwell,12.7283809439,1.88220206596,6,45,51
twisty,12.6953164749,2.58353581258,2,27,29
jimbot,12.5261010076,4.50079562529,0,7,7
phynque,12.479550573,3.45586176789,0,12,12
atlas,12.457169088,2.97116466651,1,13,14
gasmask,12.4395042051,3.91757174289,0,8,8
tyler_stewart8,12.3357868105,3.60562290568,1,6,7
microwaved hotdogs,12.3116431223,3.88798430209,0,10,10
fabulousboy,12.3090685591,3.83448828941,0,9,9
terrible fate,12.2884902705,3.52373597312,1,12,13
putpasswordhere,12.2418390377,4.50559803124,0,8,8
neph_girl,12.1857933404,2.963241195,1,14,15
doublej,12.1227182591,3.578165459,0,13,13
ohb-noa,12.1184826499,4.13659355193,0,8,8
lolitaz667,12.0538949157,3.33101778751,1,8,9
b rod,11.8123880392,5.01713980695,0,5,5
syph,11.7617864763,3.63954465887,0,9,9
jame,11.7297425952,3.37209293593,1,10,11
little things,11.6742996369,4.00884236892,0,7,7
nicklebackair,11.6278960059,3.50582108206,0,9,9
whitezebra,11.5451463164,3.58244478144,0,10,10
mambo,11.4446194592,4.89551166665,0,4,4
half man,11.4072195293,3.67255395658,0,8,8
baloo,11.3419504981,4.48888552465,0,5,5
t3rquoise,11.3175625224,3.86043234125,0,10,10
stormcrow2,11.3030445558,3.47217201793,0,9,9
ranger,11.2387136102,4.07046498738,0,10,10
reject,11.0935922845,2.51385185164,1,27,28
mello,11.021602913,3.16838637273,1,16,17
qwesseccssffdy,10.9119659948,4.9379317197,0,4,4
stevenballoons,10.8983695531,3.14226695807,1,9,10
jerry bean,10.8036285745,5.18894961288,0,2,2
knothy,10.5573959121,3.63512610692,0,12,12
2p,10.5306132945,3.31856014846,0,16,16
ceec,10.5040002946,3.438642384,1,10,11
brizzles,10.3916164403,4.01696976166,0,8,8
lloyd.,10.1777427494,3.6364754704,0,9,9
