player,mu,sigma,wins,losses,sets
bluntsmokinganusdestroyer,9.94517809644,4.08481331296,0,10,10
hwats,9.93451497081,3.55896674115,0,12,12
fog man,9.89493919044,3.44343769594,0,9,9
yung duccboii,9.87886531488,3.96575138462,0,7,7
sucksatgames,9.85468736526,3.8811711733,0,6,6
baloo,9.7541855638,4.24682858729,0,5,5
seaniemaster,9.64952917735,3.79894548379,0,8,8
big sippy,9.60093752611,3.4951635765,0,10,10
macrado,9.52464402456,3.40779924102,0,13,13
gluu,9.47280657393,3.88799316507,0,6,6
jet fuel,9.33162436609,2.90104394764,1,16,17
zoom,9.17520904377,3.50417538655,0,9,9
seaweed dragon,8.996410579,3.70650041146,0,8,8
ginger snatch,8.69779482453,3.32299711801,0,11,11
golfclubninja,8.65717494531,2.81326976782,1,28,29
shunkun,8.55792639167,3.26692588508,0,16,16
oquinn,8.47894902627,3.1653873069,1,11,12
soggy biscuit,8.46079465159,3.16928207456,0,16,16
archduke,7.49187476235,3.60730944394,0,9,9
superboomfan,51.8861493167,1.18284196747,236,11,247
alvin,49.0732858141,1.20321755301,87,11,98
fukurou,48.7634654804,1.57781203813,42,4,46
wizzrobe,46.2243790746,1.07371536918,113,25,138
kysk,46.1872572327,2.04086449427,18,4,22
kurabba,46.069895063,1.93125607133,20,4,24
wario,46.0444269037,2.2884083868,18,3,21
mariguas,46.0180951026,1.0792646789,112,24,136
wangera,45.348013928,1.69776689466,29,7,36
gerson,45.3414605741,3.02390351989,10,0,10
isai,45.2633844925,1.20091582304,78,17,95
kerokeroppi,45.123335495,1.10510079284,83,23,106
dext3r,45.033044532,1.15248817498,77,20,97
tacos,44.2045890368,1.20051358333,80,21,101
zero,44.1076443247,1.10906567177,92,22,114
prince,43.4888782469,2.14738585659,17,4,21
fox,43.4803065991,1.29605854398,56,12,68
revan,42.9772162982,1.06037845852,87,28,115
joshi,42.8685834916,1.84336149265,21,5,26
sultan,42.4771305981,3.03848180018,10,1,11
josh brody,42.3629998477,0.920832732718,220,71,291
lowww,42.2558631481,1.35350462844,53,11,64
gyaki,41.9621992827,2.64030893353,11,2,13
yu-kun,41.6824036955,3.05267095589,5,2,7
tr3gthez,41.6386416944,1.12765191893,67,24,91
hiyo,41.6306982262,2.69761834134,9,2,11
cali64nia,41.55749491,2.81595784442,10,2,12
taimai,41.2282521527,2.99858535049,5,2,7
stranded,40.8770200142,1.21348125187,63,19,82
tavomono,40.6342589957,2.56352051164,9,3,12
lord narwhal,40.1669181195,1.1827553282,60,20,80
jaimehr,40.0427557025,1.20413546661,56,23,79
robert,40.0248061161,1.31114214036,44,15,59
hero pie,39.9186978287,1.66115213051,31,9,40
dtan,39.8141079875,1.6122126811,24,10,34
kort,39.6926303896,1.11666953342,62,28,90
firo,39.6790681567,1.46247375799,35,14,49
derek,39.5873368629,1.6859764912,16,10,26
cobr,39.5310025381,1.19157304797,58,21,79
hammerheart,39.1109926773,1.25832975279,55,18,73
shalaka,39.0182583493,1.66876266483,27,11,38
ctg,38.990733251,0.97318799518,104,39,143
ybombb,38.6534833416,1.40391913203,34,15,49
sheermadness,38.6053209052,2.05452442014,16,6,22
czar,38.6045991626,1.68412618392,28,9,37
banze,38.573961212,2.45429791917,11,5,16
heropie,38.4417733464,1.87982443112,20,7,27
kd3,38.3882600427,1.05775562695,83,27,110
fireblaster,38.0544193511,0.907391599085,146,60,206
star king,37.9723519549,1.26166098449,50,20,70
handsometom,37.7323939812,2.0302676125,14,8,22
clubbadubba,37.6592466562,1.56519449389,30,12,42
kimimaru,37.6275112509,1.55748414164,29,14,43
fancey,37.6273777708,2.92655060324,8,3,11
nacl,37.6233548042,1.15024084081,52,25,77
manjaro,37.5745744452,3.148088672,8,3,11
cesar,37.5258858165,2.86579965379,7,3,10
janitor,37.4224731603,1.2317214495,60,23,83
bonobono,37.1076432096,3.30573862343,5,2,7
combo blaze,36.9567327117,1.40374256574,43,18,61
eg,36.7860308098,1.06625128453,66,29,95
shears,36.619720229,0.900250309792,174,78,252
yellowbob0,36.5650363651,3.08786334791,9,2,11
kyle tree,36.4750112986,1.91462713542,18,10,28
lorenzo,36.368313075,1.4834215656,33,13,46
marbles,36.332367214,1.15880445499,56,24,80
greginator,36.2004015538,3.47139284995,4,2,6
loto,36.1966730329,1.24338876204,42,21,63
finio,36.0847834881,1.24268268294,44,21,65
stevie g,36.0554917287,1.36292783731,40,14,54
skg,36.0460775461,1.27649757964,36,18,54
nintendude,35.8258368511,1.19717805093,53,29,82
yunque,35.8175826698,1.46875563488,31,15,46
janco,35.7667374997,1.28904343655,31,24,55
horbie,35.7659178755,1.12051713902,68,32,100
sotoh,35.7475057663,1.31945685474,42,21,63
roman,35.5327051176,1.51365593527,34,16,50
jason,35.4424907208,1.23784164813,40,21,61
nta,35.3366390236,1.5575653901,29,13,42
hydra,35.3262886538,1.70476129415,23,11,34
darkhorse,35.2200630891,0.923841775045,113,63,176
antwon420,35.0377088658,1.98887254588,15,7,22
nothing,35.0178450691,2.24135050833,14,6,20
purple circle,34.8262043085,2.83829081648,12,4,16
blondekid,34.8181026616,1.7178368138,22,11,33
jose,34.8122917138,2.59574343378,8,4,12
bloodpeach,34.800150232,1.82603879728,20,9,29
mohinder,34.7726530417,2.28915976167,10,6,16
amida,34.6833714129,2.269405235,12,7,19
hotline,34.6207820759,1.66569389466,21,11,32
$$$ jim $$$,34.5869481732,1.44875091867,32,16,48
daniel,34.4442971476,1.63057104765,21,14,35
fumbles,34.3993865175,1.86450595303,20,8,28
jam,34.3603828593,2.59395054839,8,5,13
dark gentleman,34.3263244774,1.16775926707,50,26,76
gilkaoz,34.3087849123,3.27408833935,6,4,10
letsgo,34.2939812113,1.83389338134,19,12,31
supa,34.2538278712,1.6068726899,22,13,35
wez,34.2100625362,3.55649626669,5,3,8
vinsanity,34.1038765028,1.78791563946,16,9,25
gravyfingers,34.0990196693,2.04892574042,17,8,25
timemachine,34.0256431895,1.38670629307,34,18,52
yobo,34.0212035962,1.12597427933,54,32,86
schickler,33.9273152547,2.64494193496,9,4,13
connor,33.8931946468,1.93166399968,20,10,30
freean,33.8753528046,1.23676139396,48,24,72
the ki of chaos,33.8633345922,5.89100490997,1,0,1
wookiee,33.8328961155,1.27473795886,44,23,67
madrush,33.7863189234,0.957869286959,82,59,141
cover,33.7194706246,3.25974960558,5,4,9
sedda,33.6796976705,1.24317972504,45,22,67
james3927,33.6260925009,2.52524045934,11,4,15
masterhandjob,33.5699697071,1.11389832607,54,30,84
time machine,33.4295485821,1.85088746059,19,10,29
b link,33.4210302855,3.4233122782,4,3,7
pugs,33.4203598715,1.16705542817,45,28,73
dogs_johnson,33.4004716078,1.06779114577,67,38,105
satan [turner],33.3259905133,3.29674907612,4,3,7
butt solo,33.322156546,3.84786629991,3,3,6
fishaman p,33.272616427,2.40062041234,9,6,15
shihman,33.2617538067,1.20623028649,51,28,79
raychu,33.2566280804,1.24201584444,47,22,69
dajjal,33.2561849108,1.71364333444,22,13,35
fruity,33.2399161756,3.52369954465,5,2,7
facechew,33.1235160338,3.94508944253,5,2,7
near,33.1149811397,1.66561219043,23,12,35
fray,33.0399906294,2.02864974957,6,9,15
sax,32.9976503511,2.19855506375,12,7,19
bo,32.9679355265,2.00795793295,14,9,23
snorlax,32.9590817844,1.50489556402,25,16,41
indefa,32.9480595301,1.9331750494,19,9,28
zeppelin,32.9315705413,3.10089909277,5,3,8
smash jesus,32.905929071,2.29307660496,14,6,20
monte,32.817445252,1.91677099162,15,6,21
the protagonist,32.8042630224,1.16370188826,50,32,82
sunnyb,32.7730670611,3.5395614178,4,3,7
allgreen,32.7721591268,1.85085123005,16,7,23
nickelbackstreetboy,32.7316089371,3.52248389185,4,2,6
mojomonkey,32.6758105145,2.20078720131,12,7,19
hipstur,32.6636819273,1.1001473995,68,32,100
dr. grin,32.6634038616,1.88711912226,17,12,29
mr.sir,32.6538899096,1.10623633518,55,35,90
b33f,32.554128214,1.09492761533,55,32,87
preston,32.5023273947,0.991931979337,68,48,116
j.moosh,32.4831469687,2.80489019851,9,4,13
cyoonit,32.4769226802,1.87773449901,14,10,24
poobearninja,32.4037778794,2.84303906931,9,4,13
jay_mute$,32.3996453496,1.67487611244,20,12,32
stonefallow,32.392499565,3.49415537303,6,4,10
sextc,32.3821994945,1.32991052388,30,26,56
tictactactic,32.346702612,3.83424124403,5,2,7
dishier wand,32.3274583097,1.38920355654,31,23,54
gildo,32.2701358528,1.5541578425,27,14,41
bard,32.2389641586,1.18509919872,43,31,74
th3kuzinator,32.201888485,3.336727397,6,4,10
subtle,32.1400439602,2.33572937149,13,9,22
the dark gentleman,32.0509317121,3.552146823,4,3,7
eggmode,31.9837689857,2.09828212766,13,11,24
b0n,31.9822767556,3.9641478883,4,2,6
weedwack,31.9802915006,1.56975732922,21,17,38
jay-r,31.9649987656,1.52806350844,26,15,41
dogg,31.9213428781,2.58691293485,8,6,14
knitephox,31.9139398066,2.41934327807,10,7,17
limesoda,31.8456038367,1.31778543726,42,19,61
hippo,31.8418294125,3.58040394194,4,4,8
spongy,31.8018027151,1.2559315519,39,22,61
ken,31.7996316097,5.4069569839,2,1,3
elel,31.7871628166,1.54089497117,28,18,46
tank,31.6789095261,2.48275899852,10,7,17
andykins,31.6566277663,1.13753478267,56,26,82
spark,31.655875356,2.75560277708,7,4,11
battlecow,31.6292306308,3.39844264696,4,3,7
qapples,31.5796743401,1.32901495984,32,26,58
d35,31.5589821659,1.50196829749,26,18,44
nyx,31.5474050695,2.15213987343,15,7,22
nattybroh,31.5369189623,2.65377269796,9,4,13
kirbstomper,31.5188344006,3.86445858352,4,3,7
moosh_da_moosh,31.517374649,2.09319149394,14,8,22
dr. lampy,31.429065565,1.44330750302,25,15,40
q!,31.2710886283,1.28159578342,38,28,66
tyhiggz,31.266289901,1.05064394982,57,39,96
newbtube,31.2514256183,2.25373392157,11,7,18
deathcpo,31.2464940655,1.24758228653,37,28,65
paco,31.2367795788,1.25259561637,40,28,68
commander,31.219157037,4.42278572814,3,2,5
josephzander,31.1970589582,3.43151938178,5,3,8
a to the z,31.1815175432,2.11111537208,11,10,21
rossi,31.1312028168,4.20548682927,3,2,5
saltsizzle,31.1304231654,1.73577643993,17,13,30
pete,31.0990824104,3.62685915722,4,3,7
socrates,31.0547091328,2.50376481566,7,6,13
kaz,30.9969163519,1.15556534183,51,31,82
studstill,30.9536732493,3.00999311985,7,4,11
onski,30.8874160045,1.29395244981,36,29,65
ivor,30.8866197892,4.09947611008,3,2,5
jimmy joe,30.860738622,1.08110080518,46,45,91
shanks,30.8194751997,2.93699975917,6,5,11
gunnermaniac,30.8042102359,1.97527992921,12,10,22
repsguy,30.7914931187,5.04039718708,1,1,2
borlin morlan,30.7892617194,4.17308790286,4,2,6
the big d,30.7640816294,1.31720761723,26,25,51
se√±orhen10r,30.7521299023,3.45397070328,4,3,7
miniohh!,30.7428367265,1.65421767447,20,13,33
tot,30.6935093983,3.09561865676,7,6,13
rusty,30.6758433322,1.22748850306,34,28,62
a$,30.6651619521,2.36904609645,10,6,16
therm,30.6581829237,3.99350991501,4,2,6
dubs,30.5848088535,3.18209149888,7,4,11
zeozen,30.5151944656,3.97417476235,4,3,7
joker,30.5023755108,4.04107902827,2,3,5
g0d,30.4520395022,4.37766960873,2,2,4
bowl,30.4456320066,1.63899808238,19,17,36
snowstorm,30.4413076079,2.26167068175,15,7,22
jamjar,30.4333331936,1.08774708182,53,43,96
bread,30.427885919,1.74428535014,17,15,32
skyfire,30.4231012843,1.82841032894,14,12,26
komotonoto,30.4043571201,1.98638948339,14,9,23
natty,30.3798853002,2.78633774997,7,4,11
fancy,30.324929621,4.26621049369,3,2,5
korobeniki,30.1989891375,1.27697902711,38,28,66
saintheavens,30.1897749539,3.5091079514,4,4,8
yoleo,30.1864141254,1.59248867705,20,17,37
captain l,30.1589417165,1.89799686832,14,15,29
the (.)(.),30.1409263905,2.39233603959,9,7,16
bon,30.1389242605,2.21206962955,11,12,23
pizza jokes,30.1150890639,3.52438013142,3,3,6
captain fabulous,30.0968353934,1.45624402056,27,21,48
llcstoism,30.0872568524,1.73012211743,17,15,32
lob,30.0802898211,1.90150699213,16,10,26
emptyw,30.0578494592,2.67498258133,8,5,13
rith,30.0135657531,3.90958200199,3,3,6
üö®üö®üö® wee woo wee woo wee woo üö®üö®üö® you are being detained üëÆüèªüëÆüèªüëÆüèª for being awake during real falco hours üïêüëåüèªüòè please show me your real falco registration üôèüèªüìù by smashing the mothafuccin b button,29.9609131121,4.19505800663,4,2,6
mokkori,29.9221620874,4.18659466566,3,2,5
wincancel,29.8852726727,1.91358573194,19,10,29
american patriot,29.8829999867,1.81920711748,18,8,26
moogle,29.8328805413,4.33168728203,3,2,5
bt,29.8176248844,2.17696732956,9,8,17
heny935,29.7696187908,3.94753657778,4,2,6
daniels,29.715812059,1.4700164892,27,20,47
olbus,29.7133284505,3.95724362534,4,2,6
spamus,29.6508181128,1.30619713658,30,28,58
crockett,29.6398487296,2.41039804373,8,6,14
razz,29.6361345057,1.04262645363,61,46,107
v,29.6148197796,1.36922987104,29,25,54
mr. wang,29.6048887164,4.10245695982,4,2,6
reptar,29.5806010295,1.29821966894,34,27,61
bert,29.5643139333,4.0080990431,4,3,7
pewpewu,29.5145792011,3.04399514384,8,5,13
zuber,29.4770487302,3.49373080828,3,5,8
umbra,29.4752212703,3.27260665752,6,4,10
quitrage,29.4726817321,3.26070314599,5,4,9
rocket,29.4660618594,1.33791823765,28,25,53
piratetrips,29.4424276796,2.8106095419,7,4,11
sheick,29.4387742063,3.12515347161,6,5,11
the american patriot,29.4373245494,4.21048447834,4,2,6
thord's bro,29.4318182884,3.17033928961,5,4,9
greeno,29.4211399558,1.66003916703,23,15,38
charky,29.39583202,7.17147558733,1,0,1
sarge,29.39583202,7.17147558733,1,0,1
blue,29.39583202,7.17147558733,1,0,1
dublat,29.39583202,7.17147558733,1,0,1
sampai,29.39583202,7.17147558733,1,0,1
stingers,29.39583202,7.17147558733,1,0,1
jxc,29.3881617836,2.11694084594,11,8,19
logic,29.3578618144,2.0993874026,10,8,18
natendo,29.29466528,2.06155114165,12,8,20
t-beau,29.2727543654,2.79025705043,7,6,13
reefybeefy,29.2270843566,1.83270321877,14,13,27
morino,29.2260895886,3.85461294267,3,3,6
dizzle,29.2011654386,1.37599630877,26,27,53
mustard tiger,29.0995072215,3.32198432043,6,4,10
aerosheep,29.0784693933,3.97219214182,4,3,7
nesskhalifa,29.0261918968,1.60402053761,20,19,39
toro,29.0095603006,4.38928209674,3,2,5
touque,29.0091436102,4.27614569944,3,2,5
duffman,28.9980001231,4.44960530657,3,2,5
scoback,28.9958480675,1.63575906008,23,17,40
chet dunskies,28.9799917286,3.43141181037,5,3,8
dboss,28.9268774534,2.60034834804,7,5,12
jsmirk,28.905708471,1.37764205106,32,26,58
white,28.9012599252,2.15611817202,15,9,24
yrn,28.8965953989,2.27258373173,8,8,16
fil,28.8773023771,1.37377820675,26,28,54
0prah,28.8660270016,2.85448459288,6,6,12
backes,28.8380720539,4.50152235492,2,3,5
fck vwls,28.8293001393,1.27577786845,29,30,59
kriskringle,28.8106920101,2.21626607327,10,7,17
gt,28.7712570299,0.92099276251,92,84,176
annex,28.7561293206,1.53143709031,26,20,46
pathall,28.7490720001,4.69490937675,2,2,4
bamster,28.6263457842,3.4607947188,5,4,9
a la carte,28.6155693035,3.55567576317,5,4,9
fenlet,28.5921538755,4.7415066217,2,2,4
kelvinheit,28.5861445043,1.43615002813,29,19,48
breakthrough,28.5820020061,1.95170808145,13,14,27
birdlordmasterbeak,28.5429251864,7.1211258753,1,0,1
broly,28.5136237546,2.33600440474,11,7,18
zuko,28.4822255261,1.94003252663,16,14,30
slappypoopy,28.4624381518,1.5877936714,22,18,40
purtle,28.4267460624,1.96048188484,12,12,24
riptd,28.3996972151,3.34949743463,6,2,8
phut,28.3223415456,3.99197197983,3,3,6
tvdonk,28.3203937299,4.45958674045,3,2,5
ibc,28.3130419186,3.36281447405,4,4,8
hack,28.3046312782,1.24457716188,32,29,61
coin chaser,28.2990279648,4.40912520839,3,2,5
fenrir,28.2659219659,4.67173243359,2,2,4
tonester,28.2647969684,2.04870800732,14,10,24
smurf,28.258027557,1.07158269295,61,50,111
mando,28.2418062169,1.56085849717,19,20,39
bloogo,28.2102194502,1.14798068804,39,37,76
blaise,28.2055181803,4.52219949795,3,2,5
peasantloaf,28.1958652619,4.26248928484,3,2,5
bacorn,28.1547985168,2.47680002995,9,9,18
autobaun,28.1529055021,4.53845634446,3,2,5
nattyb,28.1340321176,4.41412338,3,2,5
cody,28.1317835422,4.80621821526,3,2,5
toronto joe,28.0996945701,4.53051547838,3,2,5
batterybird,28.0646892936,4.53376969681,3,2,5
ringedge,28.0375212515,1.3879709309,25,22,47
velocity jones,28.0350089249,0.960046492942,73,64,137
professor_wizard,28.030447974,1.44223073691,29,22,51
kraines,28.0154055579,4.8746850721,3,1,4
maps,27.9853807034,1.39469426096,26,23,49
sebula4,27.9711233548,4.45140829467,3,2,5
darkneon,27.9706483107,2.52113758715,9,6,15
mr. slimey,27.9009177151,4.73772364665,2,2,4
anotherish,27.8482318501,4.74516644549,3,2,5
fake,27.8475602278,3.24753880285,4,4,8
enneielle,27.8195884603,3.84402021199,3,3,6
taiko,27.79669463,2.48691286077,8,9,17
dragoniota,27.7660977373,4.48734501111,3,2,5
waxy:joe,27.7473472924,1.34100829411,24,25,49
xor,27.7306959177,4.55622523955,3,2,5
automatic,27.723346718,1.63851770087,16,19,35
box765,27.7181771975,1.12480616518,36,43,79
maliki,27.703297336,2.08341757887,13,11,24
zyrg,27.6835978768,3.14519501908,5,4,9
xyk,27.6764184763,4.4512066855,4,2,6
rishi,27.6487288318,5.64969315522,2,2,4
kabal,27.625076721,3.87756274923,4,3,7
rizner,27.5719134465,1.76434333684,18,16,34
marlwolfe,27.552619447,3.82671112369,3,3,6
quickcav,27.5443756242,3.2565030456,5,3,8
t0mmii,27.5268971516,4.50511998972,3,2,5
duff man,27.5118969815,1.92041506767,12,14,26
viberant,27.4801107959,2.45536752532,8,7,15
king lumsy,27.4351494838,2.15180717543,12,11,23
kelpsicle,27.4042862287,4.26894308345,3,3,6
darv,27.4012274907,2.29642988148,9,10,19
r6=s2=(sr)2=1>,27.3837207563,3.80943548021,3,2,5
my buddy mike,27.3726033631,5.18401276847,2,2,4
epic!,27.338035323,3.07149224811,6,4,10
toa,27.3079268607,5.42871482802,2,2,4
beans,27.2945113175,1.70995394398,18,15,33
dpb,27.2936032517,4.60076381324,3,2,5
ern,27.2752491302,4.52152801546,3,2,5
1000,27.2336915033,5.26256748611,2,2,4
maze,27.158776673,4.91665644948,2,2,4
p21/c,27.1562891624,1.87773030345,13,15,28
pizza,27.1073393188,1.52157383524,23,25,48
okuser,27.103239521,2.2116839455,8,10,18
vanillarin,27.0980936505,3.11266416706,6,6,12
dam_tewton,27.0841438189,2.31928268575,9,10,19
meromorph,27.0813210303,5.02092214051,2,2,4
bigfish,27.0787853731,1.96948479848,15,11,26
inukem,27.0536933748,2.79636136739,4,6,10
freddy cougar,27.0208363255,5.4314485912,2,2,4
zackerz,27.0169604272,2.83286900204,7,5,12
cam2,27.002078533,2.32410003557,7,8,15
vudujin,26.9460054325,4.79897904172,2,2,4
jnatty,26.9385594408,3.09744410221,6,6,12
maniac379,26.9265389191,1.23916148273,34,37,71
the yid,26.8900819854,1.14840926054,42,45,87
craigpwners,26.8695428984,1.64146259902,15,15,30
vanddar,26.812335727,4.90847115312,2,2,4
sunflower,26.7937942656,1.38969530916,25,28,53
walkrofsky,26.7629757788,1.75062315272,12,17,29
kaladin,26.7588062893,4.84757461904,2,2,4
shake,26.7502904868,2.55982702803,7,9,16
m-angry,26.7476824137,2.1202526928,11,9,20
flanders,26.732648174,2.78667124748,7,5,12
blue lantern,26.7093340198,4.9166360115,2,2,4
fudgeball,26.6898458363,4.16016709503,2,2,4
abszero,26.6766861614,4.21915893279,3,3,6
pintoa,26.6558446565,1.83484144948,18,12,30
shyboy,26.6343030405,4.82060840724,2,2,4
cam,26.616728413,1.45143730474,24,23,47
sav,26.6103887464,2.34357462804,8,7,15
el man,26.5958391965,2.59792290927,7,5,12
synth,26.578067152,4.42366478021,2,2,4
salami,26.570096146,3.05739829309,6,5,11
dad,26.5649812647,2.90481321463,7,5,12
hoofy,26.5601174258,1.60121316318,22,20,42
wok,26.5551697892,3.22879796228,5,5,10
mr.watchandlearn,26.5228195193,4.95596810829,2,2,4
oh thomas,26.4681284015,4.31076383731,3,3,6
nalgas,26.4324148357,4.52154689818,3,2,5
clumsy,26.4231521057,5.24172278006,2,2,4
beavith,26.4032767179,2.78331814444,6,4,10
whitejesus,26.3982148826,1.23372789755,30,36,66
ham,26.394441407,1.55070749393,20,22,42
killahertz,26.3850730511,3.04266130492,5,6,11
kyle,26.3647105564,1.97692702068,13,11,24
gooby,26.3471758459,2.7825946163,6,7,13
stonehaus,26.3144683052,4.85649340991,3,2,5
big dick damage,26.2863639759,3.20913014009,4,4,8
thomdore,26.285996667,5.07756869741,2,2,4
kirbyrocket,26.2696535538,4.29315540544,3,2,5
ace,26.245751503,1.17505220747,32,40,72
stew,26.1896382645,1.3022594827,32,34,66
hhhhhhhhhhhhhhh,26.1805605948,4.94442759964,2,2,4
king funk,26.1514296284,4.12026214042,2,3,5
hypa,26.1258403992,4.79492866376,2,2,4
shishkabobs5,26.0718708003,5.37780397789,2,2,4
droc,26.0644650869,1.36760428584,24,29,53
flatvi,26.0319114639,4.22548841251,3,3,6
toxic,25.9710162951,1.89152169337,13,11,24
k rool,25.9540972811,1.32530942991,30,30,60
boomalready1,25.9453830841,3.75152378119,3,4,7
bringdaruckus312,25.8961482234,4.91181907561,2,2,4
bunz,25.8866805818,2.19367234157,11,15,26
mortech,25.8552305085,1.68459822096,17,19,36
bigbeaver,25.8372772273,1.30518312956,26,34,60
cmull,25.8138359364,3.45247071181,3,4,7
collin,25.796194034,2.28114891406,9,9,18
pale,25.7945573017,1.52610209475,20,19,39
hoofydough,25.7113062928,4.91600928402,2,2,4
lordtoko,25.6973930845,1.44189683387,21,21,42
traiman,25.6938541943,1.9604329381,11,14,25
baby legs,25.6784868712,2.56219735702,7,7,14
lookalike,25.6392861845,3.68293491127,4,4,8
webwipe,25.6289523668,3.38221109775,3,4,7
scratch,25.6079613733,1.86913165288,13,16,29
z-rex,25.5926127763,2.71196520627,5,8,13
meerkat,25.5878213051,2.38834123208,9,10,19
blmb,25.5778505114,4.74753780563,2,2,4
tbq,25.5735554737,3.35661932001,4,4,8
j9d2,25.5678331018,4.26488499498,2,2,4
chuck lubs,25.5606773425,5.02116683742,2,2,4
bovine,25.5574416055,3.10857669101,5,5,10
komodoninja,25.5477573088,2.6986919049,8,5,13
prime,25.5395155582,1.6726528538,17,17,34
hariballz,25.5354729254,3.41739874239,4,4,8
funkykong,25.5050742126,4.87107097566,2,2,4
ttt,25.4759484308,3.01663650948,3,6,9
dingo boy,25.4752119328,4.29241790974,3,3,6
justin,25.4527511204,2.69371588212,7,6,13
mixxedvegetables,25.4501743805,4.70204997659,2,2,4
sebula,25.4436295914,1.26106756655,29,35,64
t brett,25.3672268045,3.85885606305,3,4,7
starchild,25.3611312572,2.95232769534,6,6,12
griffith,25.3452938931,1.38102750685,22,28,50
nasian,25.3404237394,5.74907458247,1,1,2
therapture_,25.3258278266,5.13054155253,2,2,4
sunvulcan,25.3056739926,1.54517040563,21,19,40
lou_sanus,25.3021612391,1.35029857768,25,27,52
salt,25.2941591503,4.96321040971,2,2,4
purple fox,25.2890644797,4.58709452422,2,2,4
wazzberry,25.2821512309,4.73421942984,2,2,4
cortese187,25.2734327832,4.80713072026,2,2,4
log,25.2646532748,2.95110936259,4,6,10
swiftbass,25.2622368269,4.89216411198,2,2,4
zhu,25.2570917719,5.15198224649,1,2,3
zbl_mystic,25.2552120698,5.229602591,1,2,3
sj ryker,25.2541525953,5.20046083113,2,2,4
moju,25.2541525953,5.20046083113,2,2,4
klms,25.2540556461,4.9265753216,2,2,4
pandemonium,25.220578387,4.55214797812,2,2,4
blisstex,25.2197473536,2.96083423638,6,7,13
tbaby,25.1313997535,4.7877490953,2,2,4
qubit,25.1257493202,4.91426923128,2,2,4
tootmoses,25.1233310584,4.09740267026,3,4,7
karlthemarx,25.1124033326,4.8206721687,2,2,4
giraphe,25.0914428523,4.84082291314,2,2,4
leavescat,25.0864837849,3.53972568507,4,4,8
poptartplug,25.0826285291,5.11818158289,2,2,4
measthebeast,25.0763223413,2.09359721597,9,10,19
tom bombadil,25.0468821941,3.2776991495,4,5,9
damp,25.0462356422,4.82420329543,2,2,4
notlightningrunner,25.0432425227,4.65308130371,2,2,4
slappymcnutz,25.0295722082,1.90399405019,10,16,26
dolan,25.018968915,4.94617049301,2,2,4
beguiler,25.0181002617,5.04179208223,2,2,4
astumpyzombie,25.0,8.33333333333,0,0,0
4eyez95,25.0,8.33333333333,0,0,0
lunchy,25.0,8.33333333333,0,0,0
astumpycow,25.0,8.33333333333,0,0,0
s≈çcrates,25.0,8.33333333333,0,0,0
snazzy,25.0,8.33333333333,0,0,0
lala,25.0,8.33333333333,0,0,0
foxnard,25.0,8.33333333333,0,0,0
masterofzoroark,25.0,8.33333333333,0,0,0
adubz,25.0,8.33333333333,0,0,0
smashlopez64,25.0,8.33333333333,0,0,0
dunos_,25.0,8.33333333333,0,0,0
mojn,25.0,8.33333333333,0,0,0
rudedude,25.0,8.33333333333,0,0,0
sheen,25.0,8.33333333333,0,0,0
flayer,25.0,8.33333333333,0,0,0
hypertj,25.0,8.33333333333,0,0,0
god,25.0,8.33333333333,0,0,0
travkid,25.0,8.33333333333,0,0,0
ajp,25.0,8.33333333333,0,0,0
goomah,25.0,8.33333333333,0,0,0
marfslayer 3000,25.0,8.33333333333,0,0,0
the amazing busterino,25.0,8.33333333333,0,0,0
spicky,25.0,8.33333333333,0,0,0
reb,25.0,8.33333333333,0,0,0
name,25.0,8.33333333333,0,0,0
lukem,25.0,8.33333333333,0,0,0
oljace,25.0,8.33333333333,0,0,0
l0n3r,25.0,8.33333333333,0,0,0
johnnyfight,25.0,8.33333333333,0,0,0
dfu,25.0,8.33333333333,0,0,0
yung,25.0,8.33333333333,0,0,0
mistertizye,25.0,8.33333333333,0,0,0
dr.shots,25.0,8.33333333333,0,0,0
bulldog,25.0,8.33333333333,0,0,0
urpasmash,25.0,8.33333333333,0,0,0
aperture,25.0,8.33333333333,0,0,0
ozymandias,25.0,8.33333333333,0,0,0
branchan,25.0,8.33333333333,0,0,0
jeremy,25.0,8.33333333333,0,0,0
thac0,25.0,8.33333333333,0,0,0
tweli,25.0,8.33333333333,0,0,0
birdybirds,25.0,8.33333333333,0,0,0
chewy,25.0,8.33333333333,0,0,0
locamash,25.0,8.33333333333,0,0,0
spaff,25.0,8.33333333333,0,0,0
monk,25.0,8.33333333333,0,0,0
magitech,25.0,8.33333333333,0,0,0
[stg] overload,25.0,8.33333333333,0,0,0
bus,25.0,8.33333333333,0,0,0
puddn,25.0,8.33333333333,0,0,0
mahie,25.0,8.33333333333,0,0,0
fractal,25.0,8.33333333333,0,0,0
pilot,25.0,8.33333333333,0,0,0
juno,25.0,8.33333333333,0,0,0
kcon,25.0,8.33333333333,0,0,0
zetts,25.0,8.33333333333,0,0,0
tdx,25.0,8.33333333333,0,0,0
acestarthe3rd,25.0,8.33333333333,0,0,0
pat,25.0,8.33333333333,0,0,0
djltheescapade,25.0,8.33333333333,0,0,0
sleeh,25.0,8.33333333333,0,0,0
sambo,25.0,8.33333333333,0,0,0
sharktoast,25.0,8.33333333333,0,0,0
mimi,25.0,8.33333333333,0,0,0
eltiti,25.0,8.33333333333,0,0,0
awesomethesauce,25.0,8.33333333333,0,0,0
esuma,25.0,8.33333333333,0,0,0
deep dimples,25.0,8.33333333333,0,0,0
grunyan,25.0,8.33333333333,0,0,0
vio,25.0,8.33333333333,0,0,0
sd master,25.0,8.33333333333,0,0,0
bedgar,25.0,8.33333333333,0,0,0
dr. light,25.0,8.33333333333,0,0,0
duckpimp,25.0,8.33333333333,0,0,0
refriedjeans,25.0,8.33333333333,0,0,0
coldo,25.0,8.33333333333,0,0,0
big d [hamiel],25.0,8.33333333333,0,0,0
falln,25.0,8.33333333333,0,0,0
bird-dawg,25.0,8.33333333333,0,0,0
deku skrublord,25.0,8.33333333333,0,0,0
madguy,25.0,8.33333333333,0,0,0
bund,25.0,8.33333333333,0,0,0
ferrero64,25.0,8.33333333333,0,0,0
sadfaps,25.0,8.33333333333,0,0,0
link,25.0,8.33333333333,0,0,0
fireberts,25.0,8.33333333333,0,0,0
paul d,25.0,8.33333333333,0,0,0
werewyatt,25.0,8.33333333333,0,0,0
redeagle2000,25.0,8.33333333333,0,0,0
jarl,25.0,8.33333333333,0,0,0
spade,25.0,8.33333333333,0,0,0
k-phat,25.0,8.33333333333,0,0,0
gaon!,25.0,8.33333333333,0,0,0
zane,25.0,8.33333333333,0,0,0
levity,25.0,8.33333333333,0,0,0
mickeyrat,25.0,8.33333333333,0,0,0
fruitfly,25.0,8.33333333333,0,0,0
thomas,25.0,8.33333333333,0,0,0
chai,25.0,8.33333333333,0,0,0
gwiio,25.0,8.33333333333,0,0,0
electricgazelle,25.0,8.33333333333,0,0,0
brendanhall,25.0,8.33333333333,0,0,0
price,25.0,8.33333333333,0,0,0
4sk,25.0,8.33333333333,0,0,0
bronze_sun,25.0,8.33333333333,0,0,0
the cfb,25.0,8.33333333333,0,0,0
voidstar,25.0,8.33333333333,0,0,0
xbc30ep450,25.0,8.33333333333,0,0,0
squallette,25.0,8.33333333333,0,0,0
ldz,25.0,8.33333333333,0,0,0
high qi,25.0,8.33333333333,0,0,0
pvc,25.0,8.33333333333,0,0,0
imperium,25.0,8.33333333333,0,0,0
sabo,25.0,8.33333333333,0,0,0
flash,25.0,8.33333333333,0,0,0
filet,25.0,8.33333333333,0,0,0
cr0ak,25.0,8.33333333333,0,0,0
malkasaur,25.0,8.33333333333,0,0,0
royeric,25.0,8.33333333333,0,0,0
rf!,25.0,8.33333333333,0,0,0
rice,25.0,8.33333333333,0,0,0
nikku,25.0,8.33333333333,0,0,0
little bill,25.0,8.33333333333,0,0,0
scuttlebug jamboree,25.0,8.33333333333,0,0,0
benb,25.0,8.33333333333,0,0,0
afro,25.0,8.33333333333,0,0,0
ubll black mage,25.0,8.33333333333,0,0,0
moft,25.0,8.33333333333,0,0,0
tarn,25.0,8.33333333333,0,0,0
wolfcry,25.0,8.33333333333,0,0,0
purplefox,25.0,8.33333333333,0,0,0
karl,25.0,8.33333333333,0,0,0
neverpullout,25.0,8.33333333333,0,0,0
hyperbole,25.0,8.33333333333,0,0,0
magnus combosen,25.0,8.33333333333,0,0,0
core,25.0,8.33333333333,0,0,0
sylveonbae,25.0,8.33333333333,0,0,0
da bear,25.0,8.33333333333,0,0,0
phex,25.0,8.33333333333,0,0,0
zb,25.0,8.33333333333,0,0,0
nokto,25.0,8.33333333333,0,0,0
miken,25.0,8.33333333333,0,0,0
patty-wagon,25.0,8.33333333333,0,0,0
drake,25.0,8.33333333333,0,0,0
hail_sagan,25.0,8.33333333333,0,0,0
mouse,25.0,8.33333333333,0,0,0
donatello,25.0,8.33333333333,0,0,0
pastor,25.0,8.33333333333,0,0,0
brentosfreshness,25.0,8.33333333333,0,0,0
king lui,25.0,8.33333333333,0,0,0
redribb0n,25.0,8.33333333333,0,0,0
dezno,25.0,8.33333333333,0,0,0
emon,25.0,8.33333333333,0,0,0
k8,25.0,8.33333333333,0,0,0
8am,25.0,8.33333333333,0,0,0
flat nat,25.0,8.33333333333,0,0,0
jobook,25.0,8.33333333333,0,0,0
sussebass,25.0,8.33333333333,0,0,0
hans_mawell,25.0,8.33333333333,0,0,0
dude,25.0,8.33333333333,0,0,0
stephanie,25.0,8.33333333333,0,0,0
dobermen?,25.0,8.33333333333,0,0,0
sandman,24.9887311423,4.55877603613,3,2,5
shaddi,24.9845746433,2.77176535032,6,6,12
biz,24.9843857241,3.5070919841,3,4,7
village mascot,24.982809351,2.21847655215,11,14,25
imdabes,24.9544618082,4.9329171002,2,2,4
yass2queen,24.9521629583,5.55029356187,1,2,3
no~m,24.910354521,1.86563952023,14,14,28
girl,24.8919002125,4.65131565094,2,2,4
iheartqueso,24.8832944637,2.62854399531,8,9,17
yeye,24.8820920328,4.28031500218,2,4,6
jc_chill,24.8816904935,4.66007647926,2,2,4
hayrow,24.8760716524,5.60963176016,1,2,3
le_vinny,24.8420559904,2.13111966501,12,11,23
olikus,24.8345186281,4.491736906,2,3,5
dasit mane,24.8054783952,5.29757846679,1,2,3
pidgezero_one,24.8030371179,4.92260328023,2,2,4
7blanks,24.7857655914,4.03426846924,3,3,6
tafokints,24.7543163787,5.98230366142,1,1,2
alex,24.6972337732,3.92244780764,3,5,8
schmerka berl,24.6945408355,2.51969328896,7,11,18
doughnut,24.6929943538,4.82500327756,2,2,4
daddy's milk,24.6676866237,4.12856247254,3,4,7
blueman,24.6558311059,4.14457051057,3,4,7
soulbroker,24.6490965711,4.77612071047,1,2,3
dankestdad,24.6441605985,3.67631896172,4,4,8
barron,24.6389957691,5.14166158817,2,2,4
hotpocket,24.6350723086,2.51082265845,8,10,18
mmneggs,24.6320987066,3.37482023672,2,6,8
tetsu0,24.6262993259,5.03796166079,2,2,4
handles,24.619750563,2.10932311611,10,11,21
drinkwildturkey,24.6184041258,3.38178287968,4,4,8
dount,24.6060569127,4.09402006283,3,3,6
whuck,24.5828430357,4.01651529369,2,3,5
pupperina,24.5784536204,4.66773630143,2,4,6
et,24.5591990669,1.87298721165,10,18,28
thissidedown,24.5513665815,5.43925573599,1,2,3
aces,24.5437369718,2.6312397418,6,11,17
papaghanoush,24.5376963392,3.37654628126,3,4,7
tmakk,24.5320583719,3.24729154585,5,6,11
fanboy,24.489218521,5.72537316694,1,2,3
cashhole,24.4825960328,5.40963255151,1,2,3
collin the conqueror,24.4582480014,5.06356359914,2,2,4
satch,24.4484190474,5.04404046701,2,2,4
dusttin,24.4448147746,2.20736387966,10,13,23
milleneum,24.4437383746,1.9840087365,11,14,25
luigikid,24.3990684268,5.00184242285,2,2,4
jazzy jinx,24.3888989225,4.61063078292,2,2,4
pettanko-senpai,24.3844493572,2.65987920532,7,6,13
queso,24.3840555805,1.50389971527,17,24,41
cam1,24.3829383319,1.90113876858,11,11,22
byff,24.3531958835,4.42616651113,2,2,4
tauvalian,24.3283622006,5.04985079081,2,2,4
chicken,24.3150350295,2.97943130127,5,7,12
gamer4life,24.3124970373,4.62810252074,2,2,4
reese,24.3021092979,4.43609296046,2,2,4
three deaths,24.2999940058,2.39715714487,10,7,17
cwic-beam,24.2622187192,1.63638383371,16,19,35
sombrero,24.2277990286,5.24583204617,1,2,3
principal coffee,24.2236022086,2.53950561713,9,6,15
monkey,24.2221263008,2.04287361758,10,13,23
esid,24.2120229199,2.14036274482,10,9,19
enemajoe,24.2011786585,3.24380615725,4,4,8
smashg0d,24.1473408161,5.37571815839,1,2,3
k-nut,24.1365368992,4.29427694186,2,3,5
drewgong,24.1276672543,1.78034983069,13,16,29
chevrium,24.0998993232,3.68940614203,3,4,7
staysleepin,24.0954660122,2.88199251767,4,8,12
shamsavior,24.0562820956,2.14469885002,7,12,19
moustasher,24.0479625062,1.36851182762,22,32,54
skrull,24.0383943224,4.94518308631,2,3,5
gaggleforce,24.0323668,5.21688036149,1,2,3
pzero39,24.0206796142,2.11876439815,10,15,25
lou sanus,24.0038689222,2.75942908722,4,9,13
widdy,24.0019917153,1.3383512858,31,37,68
thrillhouse,24.0007339958,1.45216394363,21,24,45
sunshinetk,23.9911996257,4.72938122836,2,3,5
dsj,23.9776734507,2.67211930265,6,6,12
jinjo,23.9700897429,5.5704973186,1,2,3
natural brother,23.9671398218,2.89871507545,5,8,13
kevine,23.9477325873,5.60074788092,1,2,3
costaricancool,23.9301440452,4.56037777054,2,3,5
cillies,23.9294840434,2.11952729694,10,9,19
slippypickle,23.9214953438,4.27449255921,2,4,6
nuggzy,23.9133660777,4.78267472168,2,2,4
savior,23.9066200188,4.95478696927,2,2,4
wubbs,23.8944667984,4.94122804262,2,4,6
ders,23.8849269429,3.70817323314,5,4,9
jaquarium,23.8404794066,5.04087719999,2,2,4
khakis,23.8195168002,4.66275126303,2,3,5
grahamaglam,23.8164353171,1.97974151605,8,14,22
dirtcruncher,23.8081402995,3.34522410514,4,6,10
camerino,23.7661018984,4.17038690665,2,4,6
waldo,23.7646256745,4.19581934854,2,3,5
cmac,23.7624468223,3.2970522857,4,6,10
monad,23.7373212149,1.50883370909,17,31,48
gaijilla,23.7335000994,5.89458141807,1,2,3
mr. biz,23.7210641953,5.05089869586,2,2,4
lotus eater,23.7116515581,2.80236050393,5,6,11
elrond,23.7000605562,1.54288919001,18,26,44
probers,23.6805130162,4.62729514735,2,2,4
truffleshuffle,23.6788769285,4.52693030002,2,3,5
zenaga,23.6761009151,5.50042648943,1,2,3
icho,23.662896248,4.88366621654,2,2,4
sk,23.6269155748,5.64613700625,1,2,3
majin_bukkake,23.6221143861,1.9493944036,11,16,27
dsyr,23.6117795976,3.86167393469,2,2,4
puncayshun,23.6094493635,3.55914134818,4,3,7
kurow,23.5986452288,7.48026808435,0,1,1
hunter,23.5792575204,1.68804731572,16,17,33
searing scar,23.574866726,4.41158887627,2,4,6
wheels,23.5725648946,2.1845302814,8,7,15
derstuk,23.5635403323,2.14861512671,10,12,22
capos,23.5498398263,1.11559328551,43,54,97
izoo,23.5371695413,5.42181231484,1,2,3
b.i.,23.5266511245,1.96224479909,9,13,22
file,23.5258214233,2.60650897742,8,5,13
twan,23.5253509879,3.21265905233,5,3,8
gera,23.4898486031,5.53310149373,1,2,3
bi-lo adachi,23.4888258333,3.38590640746,4,5,9
kingkool,23.4818263461,2.48809398051,8,10,18
arctic,23.4684294881,5.40148296815,1,2,3
moze,23.4592288604,4.98526512836,1,2,3
chronicmexican,23.4520360371,2.4503717352,6,12,18
sonicfuzz,23.4101932962,2.02812940932,12,15,27
-philip coast philip-,23.3697043425,5.25692690117,1,2,3
pochilin,23.3686415636,3.89578154083,3,5,8
steamfriedasian,23.3621246951,5.73391255533,1,2,3
rawdog,23.3586974349,5.06412893915,2,2,4
wal,23.3419750632,5.72588669497,1,2,3
sph,23.27614359,4.5186933381,2,3,5
chino san,23.2691874563,5.4715624474,1,3,4
neth,23.1861020266,5.49320539377,1,2,3
qtip,23.1471201424,5.96320374501,1,1,2
dwreck,23.1427050378,5.50870913819,1,2,3
bre,23.1081142714,1.84531999251,12,15,27
andy,23.1067284227,2.0159940875,10,12,22
clefairy as mew,23.0927379524,4.95371121424,2,2,4
matt,23.0865413455,3.24575348333,3,5,8
bottle opener guy,23.0632797645,3.36323503128,4,4,8
aguos,23.0598851704,5.54794149378,1,2,3
xanz,23.0545148072,5.12641315059,1,2,3
masquerade,23.0480593414,5.50126583567,1,2,3
ardent rage,23.0390518825,5.33053236201,1,2,3
bimbo,23.0263984695,2.95045653793,4,5,9
dex,23.0157579329,7.26303928778,0,1,1
garv,23.0087701032,3.94332664324,2,2,4
gibbles,23.0028076724,4.98614184348,1,2,3
kman,22.9932321123,5.67901093998,1,2,3
minymidge,22.9907192055,2.16976412364,7,16,23
billbacon420,22.9500961373,1.4309842647,20,31,51
ajbcdefg,22.9384289265,1.43793872037,22,29,51
ditto,22.9337202157,2.34298502719,7,11,18
pluto,22.9093362416,5.56220097291,1,2,3
biscuit,22.8662146651,5.74469940782,1,2,3
nigel_thornberry,22.8525552656,5.24517339621,1,2,3
duncs,22.8458202929,1.45486629275,24,29,53
brny,22.838748422,5.26669002508,1,2,3
bean,22.8178140193,1.74943476674,12,25,37
zibba,22.8170969194,7.24300767435,0,1,1
elu,22.7969622246,2.06120152812,11,18,29
silver,22.780904804,3.15371303876,4,6,10
greenblob,22.7805461004,2.93636339852,4,7,11
racilor,22.7676865956,4.67885299124,1,4,5
bodacious,22.7456335897,4.10770698892,3,4,7
bonerstorm,22.7131543348,5.03759629022,1,2,3
egg,22.6868315234,7.13619990605,0,1,1
verwaltung,22.6867102224,5.67101579923,1,2,3
goosewithsocks,22.6854733962,1.55775448594,18,23,41
drewskii55,22.6773296708,7.1998936357,0,1,1
crazyk115,22.675195546,5.13123091144,1,3,4
xif,22.6534817717,7.12557083651,0,1,1
nanagens,22.6381707711,2.842449372,7,5,12
aisengobay,22.6293808255,5.02187166669,1,2,3
boh,22.6263883891,5.22409885802,1,2,3
cooljoe,22.6161343304,5.22917378086,1,2,3
cyan can,22.597335078,3.57011809798,3,6,9
dankpank,22.5918834602,1.35801900081,23,33,56
jlo,22.57842161,2.37191247776,9,10,19
foda,22.5759376373,1.94123027002,11,14,25
cuppajoe,22.5614711416,3.98912966001,3,4,7
rgood,22.5504742507,5.20983845717,1,2,3
evals,22.5497261156,5.26109394584,1,2,3
robnu,22.536172251,5.27296940229,1,3,4
schlag,22.5295736344,5.64093463869,1,2,3
zhao_guang,22.5277237515,5.28057703468,1,2,3
keagsbsmashin,22.505682607,4.93161471885,2,2,4
stylisland,22.4970786889,4.90556046625,1,2,3
chiefreaper,22.4961205317,5.37600170459,1,2,3
asaaj,22.4772513227,3.20358469471,4,4,8
lldl,22.4754387364,5.54602983821,1,2,3
momdameatloaf,22.4682983546,2.75704794254,5,6,11
bflakes,22.4601759403,1.93952302425,11,16,27
bohemian milk,22.4410234019,5.64191828862,1,2,3
mourin,22.436189438,5.53322447519,1,2,3
bhol,22.4337444531,1.87672446493,11,16,27
rythemretrn,22.4257927027,5.54390698698,1,2,3
okay,22.4201728471,5.79958407668,1,3,4
leaf fc,22.4135995398,3.30091393833,4,6,10
hsf,22.3577182729,5.21749074515,1,2,3
tokaji,22.3418384892,5.72549549374,1,2,3
the professor,22.3357851457,3.93517245049,3,5,8
panda,22.3313012989,2.86983820503,5,9,14
maaron,22.3235126558,5.2279102694,1,2,3
rebel scum,22.309971187,3.35235257188,3,5,8
mickeyo64,22.2960481631,5.09800383723,1,3,4
yakal,22.2950630033,5.45881954507,1,2,3
happens,22.2847654025,3.38255714468,3,5,8
reckless,22.2777886196,5.54771180862,1,2,3
green eggs and spam,22.2713050426,3.97567059929,2,4,6
hotahota,22.2706104058,1.74543771113,17,14,31
sun vulcan,22.2633593669,3.97593915296,2,4,6
adrian,22.2449221962,5.4939042246,1,2,3
moonshoe,22.2392208031,1.22630791304,30,49,79
geekliftus,22.2334848055,5.51993490319,1,2,3
train_town,22.2182491195,5.25970810876,1,2,3
squible,22.1925963747,2.73991600846,6,7,13
prism,22.1844388475,5.77138158298,1,2,3
grrg,22.1708161254,2.56948356915,6,11,17
toez,22.1708132151,5.1827586053,1,2,3
cbones,22.1425979996,5.17784168517,1,2,3
ocelot,22.1012001213,2.14057529301,6,17,23
zergos,22.0991405184,3.25290245754,4,6,10
omar,22.0873057251,4.52911632269,2,4,6
giraffe,22.0832446758,5.52720444839,1,2,3
cormander,22.0730034046,1.74692246246,13,22,35
mrryanness,22.0451209734,3.72964228852,3,7,10
crip,22.0417499629,5.72015962435,1,2,3
honeybadger,22.0417499629,5.72015962435,1,2,3
hamburglar,22.0313772247,5.47262274073,1,2,3
dr.yonz,22.0286362773,2.19815727116,8,10,18
wowzers,22.0102507868,3.63199397195,3,5,8
hbrw-hammer,21.989450955,5.19683618143,1,2,3
mrpoo,21.9694395301,5.5090539933,1,2,3
banana fiend,21.9571408911,5.00477127102,1,2,3
zarc,21.9523180178,5.3661603852,1,2,3
han,21.8966597569,5.31977588561,1,2,3
papasquat,21.8903931512,1.62420476372,12,27,39
kzidek,21.8867795024,5.53430238446,1,2,3
multiball,21.8320114943,1.66776452652,15,24,39
sebson,21.7690532328,4.86714048255,1,3,4
kaddy,21.7448383797,6.97871477739,0,1,1
kristoff,21.7236989215,1.91457160532,12,19,31
pizzajokes,21.7162054905,5.50815225737,1,2,3
paco [larkin],21.7159475813,5.45508770932,1,2,3
fawnco,21.6867950646,5.49425252058,1,2,3
burnt out ninja,21.6867950646,5.49425252058,1,2,3
cardoso,21.6780577038,5.47180539926,1,2,3
hotspank,21.6599191069,1.47363121526,18,28,46
nikademiks,21.6556587051,3.47749179461,5,3,8
gumbolaya!,21.6434793433,5.28700972786,1,2,3
dax$,21.6369090505,2.65521155168,6,6,12
h2o,21.6326985812,2.87955017039,6,6,12
eggmcmuffin888,21.6299238206,2.4876592225,5,9,14
elated,21.62548673,2.0588089455,9,16,25
moonlight,21.6022521798,2.70296169925,4,9,13
calzum,21.5727920772,5.33794640948,1,3,4
yolochi,21.5674602717,2.39071683625,7,13,20
peaceful soujourner,21.5596302999,5.17234998146,1,2,3
iceking,21.5434449551,2.74124330622,5,12,17
halffulla,21.5401255137,3.47382091851,3,5,8
macintosh,21.5372392958,3.43669403195,3,6,9
slartibartfast42,21.5328392932,4.28071789839,2,4,6
evab,21.5281310611,5.45654170068,1,2,3
l3w!,21.5261013011,5.11492796981,1,2,3
ondas,21.51339165,3.48788136518,3,5,8
anathema,21.5047657545,5.52858492613,1,2,3
jirachinick,21.5047657545,5.52858492613,1,2,3
glennwood,21.5047657545,5.52858492613,1,2,3
kossismoss,21.5047657545,5.52858492613,1,2,3
zwephy,21.5047657545,5.52858492613,1,2,3
zombie!,21.5047657545,5.52858492613,1,2,3
trevman,21.5027061159,5.10402665286,1,2,3
weirdy man,21.4938394777,5.32664823819,1,2,3
sadu,21.4831253742,5.56869670732,1,2,3
tipc,21.4721568925,2.906610807,4,8,12
dugdiaz,21.4602644973,2.88342798722,3,7,10
tubby!,21.4588417926,4.56514615723,1,4,5
xiivi,21.4496962562,2.85386214119,5,9,14
jmabate,21.4375021927,5.28753891929,1,2,3
fearlesscaboos,21.4290211813,5.32540817218,1,2,3
v-bomber,21.4000216092,4.19284654502,2,4,6
second boss,21.34715835,3.51634467714,3,4,7
whoopiecow,21.3422581477,5.51129103904,1,2,3
napkins,21.3422581477,5.51129103904,1,2,3
bubby,21.3396390978,5.35310713357,1,2,3
boink,21.3310475363,3.33664381683,4,5,9
pikasneeze,21.3091546757,2.7548339252,5,6,11
three beers,21.2794834712,2.62843174097,4,8,12
fish,21.2727927064,7.11056318404,0,1,1
dair,21.2557562186,3.1904892393,4,4,8
minusev,21.2310105936,7.09851357382,0,1,1
frostbyte,21.2308154007,3.47773616452,3,7,10
vinvinn,21.2048356128,2.27999957152,6,11,17
chunky's cheese,21.2039881016,6.41037670026,0,2,2
a dog,21.2006338247,5.2780201564,1,2,3
jdp,21.1604359188,5.11371184679,1,2,3
blue bear,21.1002964099,5.55587524657,1,2,3
frog,21.0794189084,3.2480029824,4,7,11
kavon,21.070209472,5.51002169606,1,2,3
shasta,21.070209472,5.51002169606,1,2,3
hungrybox,21.0467231473,4.48911181511,2,4,6
mizbiz,21.0466012082,3.26551475343,4,4,8
zouzy,21.0418048278,5.55922924101,1,2,3
static,21.0361805828,3.56635009013,3,5,8
bawdbabe87,21.0322017522,2.27052041981,10,14,24
fingerblast,21.0282944416,4.56717243747,2,2,4
bombproof,21.0110873187,1.8061439153,12,17,29
keatsta,20.9843034598,5.12985218833,1,2,3
hipo,20.953075175,5.25579614463,1,2,3
catastrophe,20.9503451665,3.70285754216,3,4,7
doby,20.9455223802,4.83858139673,1,2,3
dr combos,20.8912518237,3.27800280583,2,8,10
tallboi,20.8890050933,6.62580951244,0,1,1
fuzzyness,20.8757588528,5.24485548902,1,3,4
gray,20.8741791655,2.70173121698,5,8,13
java boy,20.8688053303,5.51600461343,1,2,3
jaapoh,20.8565518325,3.37605596922,3,4,7
yungpurp,20.8565440875,6.68399882972,0,1,1
apparition the ambassador,20.8530911913,1.2053334935,25,55,80
big tone,20.8429637361,7.05911462831,0,1,1
seantos,20.8355779457,1.94148645876,11,23,34
ttp,20.8037683646,3.4515325121,3,6,9
zad,20.8025162392,3.39146514183,3,7,10
eliot,20.800150921,4.9216372622,1,5,6
fork?,20.7954624437,4.94915592418,1,3,4
dankey kang,20.7882167966,2.15312942829,7,17,24
cookie,20.7792008652,6.26044908577,0,2,2
teflon ron,20.7743167383,3.31871768139,2,6,8
zach777,20.7736677983,6.44988557306,0,2,2
mojo,20.758940526,5.19849799532,1,2,3
lalo,20.7455633083,4.13912238987,2,4,6
buttery adachi,20.7363992656,4.64326906141,1,3,4
lucky_hamburger,20.7141388752,2.95820620078,4,7,11
tangerine,20.7036397082,1.74448455344,14,22,36
zerobombjake,20.6545537924,2.04730763588,9,15,24
ensindic,20.6231880072,2.04771247377,9,16,25
mystery,20.60416798,7.17147558733,0,1,1
captain murphy,20.60416798,7.17147558733,0,1,1
penance,20.60416798,7.17147558733,0,1,1
changed man,20.60416798,7.17147558733,0,1,1
ragingcherry,20.60416798,7.17147558733,0,1,1
sfat,20.60416798,7.17147558733,0,1,1
nfreak,20.60416798,7.17147558733,0,1,1
nyani,20.60416798,7.17147558733,0,1,1
fs shampoomaster,20.60416798,7.17147558733,0,1,1
silent skyler,20.60416798,7.17147558733,0,1,1
josiab,20.60416798,7.17147558733,0,1,1
uprowr,20.60416798,7.17147558733,0,1,1
benbook,20.60416798,7.17147558733,0,1,1
akito555,20.60416798,7.17147558733,0,1,1
jad,20.60416798,7.17147558733,0,1,1
akajumo,20.60416798,7.17147558733,0,1,1
phalanx,20.60416798,7.17147558733,0,1,1
thissideup,20.60416798,7.17147558733,0,1,1
bunmira,20.60416798,7.17147558733,0,1,1
yung god,20.60416798,7.17147558733,0,1,1
5000candlesinthewind,20.60416798,7.17147558733,0,1,1
lonk,20.60416798,7.17147558733,0,1,1
drewjames,20.60416798,7.17147558733,0,1,1
4 phri,20.60416798,7.17147558733,0,1,1
sherb,20.60416798,7.17147558733,0,1,1
nannose,20.60416798,7.17147558733,0,1,1
kayo,20.60416798,7.17147558733,0,1,1
k-man,20.60416798,7.17147558733,0,1,1
the predictor,20.5859389191,3.05066985591,4,6,10
nuro,20.5843013507,5.43716215887,1,2,3
maher,20.5765130073,5.42879585881,1,3,4
jaws,20.5676658066,5.35482917924,1,2,3
weedlypuff,20.5620585695,2.81751897523,4,10,14
moist,20.5281445459,4.25078653283,2,4,6
flatline,20.5164882806,5.24452888369,1,2,3
thenuge,20.5013392426,5.04003806029,1,3,4
haf,20.4957453639,2.44635845766,6,10,16
icactusdog,20.4936215984,1.16307993179,31,76,107
joel,20.4489952945,2.79809401547,5,8,13
heartsdealer,20.4352434283,4.22339731315,2,4,6
voff3,20.4221610927,7.01236351457,0,2,2
barrels,20.4103697104,3.86287339816,2,6,8
throwz?!,20.3712944246,5.17095114858,1,2,3
homemadewaffles,20.3612733202,6.92690169084,0,1,1
el rabbito,20.3414295746,5.22933943015,1,3,4
rat,20.3274980355,3.3965718176,2,5,7
acerunner,20.3169451819,3.84140528013,2,5,7
mr baninawi,20.3034225788,4.50399658276,1,2,3
hero,20.3003305973,6.88831159169,0,1,1
spunker,20.2808413718,6.64362796217,0,2,2
e-jager,20.2664210068,4.96604787893,1,3,4
caelan,20.204195046,7.0610632401,0,1,1
papa,20.1886580783,3.05255073155,4,8,12
jag,20.1877635794,3.03163709962,4,8,12
butcher of bakersfield,20.1709924669,3.98886789201,2,5,7
mikeyp,20.1574699988,2.64353390735,5,10,15
stormcrow2,20.144720426,2.29491557722,5,12,17
shug,20.1423880259,3.31203193609,3,8,11
fritz wethermyb,20.1350845885,6.19964761644,0,2,2
mjim,20.1299624384,2.70112772847,4,12,16
izze,20.0883722622,4.69145056366,1,4,5
kosher,20.0855713107,1.75579738182,13,21,34
howdy,20.0426628521,2.07129903513,11,16,27
nich,20.0269632329,3.24618505752,3,10,13
zephr,20.0265585836,4.95258600964,1,3,4
accru fenix,20.0058571802,2.89856788897,3,10,13
aegeze,20.0029987073,3.37362729912,3,5,8
mighty afro dighty,20.00050893,3.66729853751,2,4,6
b vu,19.976770482,6.56438077202,0,1,1
depressed eagle,19.9668557046,4.71517261952,1,3,4
stark,19.946112569,2.13258929885,7,15,22
tallyshell,19.934214378,5.03744674898,1,2,3
weatherman,19.9276209784,6.05371578566,0,3,3
kiwi,19.9254606088,3.21139323634,2,7,9
russellsprouts,19.9139748678,1.17447540592,29,75,104
pokmo,19.8957997012,2.97908126363,3,8,11
pika,19.8665160974,4.50476058035,1,4,5
mooseman,19.858732185,2.33903134795,8,11,19
brotherly,19.8508900716,2.79508369881,4,7,11
dad's musical erasers,19.8497643097,6.35255124253,0,2,2
frogman [charette],19.8470685379,6.53515646093,0,2,2
mikelangelo,19.8411042163,6.45109191965,0,2,2
king robin,19.8214996321,5.18757257798,1,3,4
spt,19.8163018158,6.39220654309,0,2,2
danny,19.8128864133,6.83164246741,0,1,1
maximum can,19.7913963128,6.17551588645,0,2,2
buddysyst3m,19.7705613463,3.05394613943,2,5,7
nineball,19.7651210643,2.98546237993,3,7,10
bunme,19.7190885673,4.31699414902,1,3,4
kingcake,19.655278355,3.93371828542,1,3,4
james bong,19.6509373309,3.04954120804,4,9,13
sebastian,19.6354572266,2.92167920647,4,8,12
elvis,19.6148889045,2.07532094825,7,14,21
memez,19.6074132571,3.27254918049,3,5,8
rogue1wasjustok,19.5957528828,2.87915628507,3,8,11
muse,19.5661656939,2.17144355463,8,14,22
yaron,19.5195470768,3.68960019688,1,6,7
goose,19.4938195039,3.66853418548,2,6,8
kuso,19.4888408706,5.19655189281,1,3,4
mr. tit,19.487802999,2.03935827861,7,15,22
fiasko,19.4796463801,4.80330110836,1,3,4
danno,19.4480883685,5.26348120732,1,2,3
diveo,19.4152478768,2.22989112894,6,18,24
dimension,19.4061385287,6.20651346822,0,2,2
fred,19.3513731126,4.82057914582,1,4,5
lil devil55,19.3372656866,6.50140744992,0,2,2
fumofuu,19.3003820949,6.70094005858,0,1,1
veen,19.2649590252,6.50769593739,0,1,1
aeremox,19.256152677,2.34089189284,6,10,16
houndour,19.2417696056,4.73961253472,1,5,6
missingn0,19.1950717181,6.10648839204,0,2,2
krypto,19.1841673017,4.81601129522,1,4,5
rush,19.1632621186,2.88221277749,3,9,12
bluebear,19.1508060281,2.67996728916,5,10,15
husker,19.1407514841,4.23594874856,1,5,6
laugh,19.1341431697,2.80800576327,4,10,14
crazy_cubano,19.1306512542,2.27391260667,7,11,18
slatts,19.1006250897,1.75915046278,10,27,37
thinking man,19.0806071757,3.26112886238,2,6,8
bleachfanboy4life,19.0620507671,5.04496622379,1,3,4
brown_omega253,19.0491830601,6.33093343935,0,2,2
k,19.0368392144,5.94893247223,0,2,2
digital cannon,19.0288693367,2.87436246899,4,8,12
supernuggit,19.0187387889,2.47683611256,5,12,17
esmod,19.004211349,6.50799591405,0,2,2
skubtard,19.0028728103,6.87267909617,0,1,1
fs mook,19.0028728103,6.87267909617,0,1,1
jiffypop23,18.9780743592,3.36022647472,3,6,9
rabizkoshik,18.9387563269,4.96521521123,1,4,5
kingcool,18.9351088349,3.64474619053,2,6,8
guccipivotmaster4000,18.9347382351,6.43705129894,0,2,2
dixoncider,18.9221109721,2.98199140416,4,9,13
ego,18.9220364506,6.43080985891,0,2,2
bananabolts,18.9170921034,4.13137927951,1,5,6
precookedbread,18.9052180392,6.13144583345,0,2,2
engdrew,18.880614279,2.71582901835,3,9,12
dcmaster,18.879290923,3.30979716407,3,6,9
obby,18.873808225,6.37979211822,0,3,3
luwolf,18.8528289655,6.29676283428,0,2,2
fry,18.8354535746,1.99190288858,8,22,30
quentendo,18.827404956,6.15822479675,0,3,3
qu'importe,18.8258791523,3.21267183502,4,4,8
neat,18.8098545779,2.45610321182,4,17,21
muthalova7,18.808759604,3.29849507466,4,5,9
blizz,18.7928519856,6.79635578797,0,1,1
turtlpower,18.7895018776,6.35251859374,0,2,2
littlespoon,18.7802214939,6.35987476929,0,2,2
mr.e [rohr],18.7703709704,6.52341434227,0,2,2
flare,18.7497987993,4.81992529848,1,4,5
iacme,18.7083010866,5.87564021133,0,2,2
cagt,18.7035808441,1.43491120625,19,34,53
jive turkey,18.698840596,4.18547904908,1,4,5
duck chris,18.6843486974,6.48895532793,0,2,2
fen,18.6651960945,4.60992013254,1,4,5
h00n,18.6630517327,2.24451151081,3,11,14
kali mist,18.6561129677,4.74050198529,1,5,6
shreddern64,18.6378812084,4.67552358982,1,3,4
jgin,18.6138243448,5.91644299953,0,2,2
kieuarty,18.6114712808,6.46332300431,0,2,2
youtwo,18.6056078068,6.49184921396,0,2,2
captain hook,18.6025152807,3.02072214515,3,6,9
takuto,18.5962462542,2.52973161791,5,10,15
el guapo,18.591035869,3.21462103059,2,6,8
qerbstomp,18.5907954406,3.12730340598,3,12,15
ltdan,18.5599920405,4.30735301086,1,4,5
kl3an,18.5588529466,6.38820575423,0,2,2
r.o.m.,18.5588529466,6.38820575423,0,2,2
pokeiman_master,18.5516219727,6.44406310517,0,2,2
crazycat,18.5424400907,3.16758016653,3,6,9
tdp,18.5322048421,6.27670782881,0,2,2
nathansandwich,18.528992419,3.36736283422,3,7,10
lecceo,18.5224563478,6.04122538682,0,2,2
failcant,18.5036619979,6.53954925511,0,1,1
tbone,18.4739919389,6.26372813517,0,2,2
nagurnimaster,18.4700890997,6.22509745584,0,2,2
superkirby,18.4611593024,6.07126152759,0,2,2
ender,18.4549193229,3.08675655552,5,6,11
pugdaddyfre$hlyfeogg*flva,18.4491791431,6.2655689814,0,2,2
reno,18.4482558464,5.7933455433,0,2,2
myninja,18.4376385639,4.38075340335,1,4,5
dance!!,18.4342509198,4.27524142999,1,5,6
polarbair,18.4282920513,2.21176822989,8,18,26
professortoke,18.4282005878,6.40611160598,0,2,2
swerve,18.4029930603,6.39919902858,0,2,2
stdangerous,18.3869320511,6.13518467314,0,2,2
big d squirrels,18.3847671628,6.39555690356,0,2,2
magic,18.3660027271,3.17604159459,3,5,8
master jay,18.3609401588,6.39052231831,0,2,2
shwang,18.3577767565,6.2521714548,0,2,2
nami,18.3449675847,6.12168390994,0,2,2
albinosaurus,18.3408647977,6.15904885894,0,2,2
the priest,18.3349179665,2.99962619471,4,6,10
charlie harper,18.3330999134,6.38313840111,0,2,2
hasme,18.3202081908,5.59655801937,0,3,3
oxycontin,18.3049578438,4.56472838053,1,4,5
silky johnson,18.3040092834,3.28397707702,2,8,10
mntd,18.3037506343,3.37480634304,2,7,9
blackf00t,18.2957405055,6.11791947838,0,3,3
quinceprince,18.2944270184,6.23604937648,0,2,2
tangpootie,18.2510894529,2.52813995041,5,12,17
jesusisking,18.244999185,6.14113063168,0,2,2
xlax,18.1874527175,4.71791538095,1,4,5
blues,18.1872371134,4.80984283879,1,4,5
arcangel,18.1524311598,4.24661981439,1,5,6
elmustachio,18.1178019254,6.11091424803,0,2,2
uncle e,18.1177269983,2.74111533003,4,7,11
chi-fence,18.1032071245,4.40192375133,1,4,5
shawarma habibi,18.1006083149,3.43125374474,2,6,8
jdeezel,18.096134607,6.31705839702,0,2,2
kitchensock,18.0916563742,2.20922312807,6,12,18
tylenol jones,18.0758497583,6.32077271178,0,2,2
avian,18.0712867461,6.31842389736,0,2,2
erk,18.057496334,6.31248192558,0,2,2
broonz,18.0512661826,1.82143953462,10,27,37
armagreggon,18.0434270235,3.49745409565,2,5,7
g-rabbit,18.043236991,2.53901471245,5,12,17
warmachine1919,18.0428187692,6.46387437135,0,2,2
sweaters,18.0428187692,6.46387437135,0,2,2
jpoptosis,17.9980023599,6.32119878345,0,2,2
astropancakes,17.9980023599,6.32119878345,0,2,2
drhino,17.9980023599,6.32119878345,0,2,2
firefly,17.9980023599,6.32119878345,0,2,2
snack?,17.9980023599,6.32119878345,0,2,2
yam$,17.9980023599,6.32119878345,0,2,2
lexi,17.9729324925,5.92956035083,0,2,2
lights,17.9722012086,6.29535962389,0,2,2
beaver,17.9564848443,6.3115571796,0,2,2
goshzilla,17.9127657948,2.60134285095,4,11,15
√°1,17.8846902537,2.5923862346,2,11,13
pajhomas,17.8627808696,4.28722969581,1,4,5
itg,17.8551620845,6.67621935994,0,1,1
ebay,17.8407852112,6.26851580688,0,2,2
mrpoopee,17.839309148,4.35417954177,1,3,4
armor,17.8270005524,6.29388615473,0,2,2
mulkster,17.8270005524,6.29388615473,0,2,2
bc_burns,17.8270005524,6.29388615473,0,2,2
legoman,17.8270005524,6.29388615473,0,2,2
akiva,17.8270005524,6.29388615473,0,2,2
chaos pro,17.8270005524,6.29388615473,0,2,2
jfm,17.8270005524,6.29388615473,0,2,2
dhir,17.8270005524,6.29388615473,0,2,2
brambramjam,17.8232000718,6.04605326041,0,2,2
frame,17.8128713014,2.36731888112,4,19,23
ccm,17.7994831008,4.04505008735,1,6,7
espparadox,17.7963733159,1.66103441323,11,33,44
massimo,17.7929138053,5.80630293942,0,3,3
austntatious,17.7829509186,6.06931121416,0,2,2
trogdorbad,17.7767969922,4.8798480296,1,2,3
aerodet,17.7621992968,6.37995413731,0,2,2
nadamoor,17.7581945491,6.26709394311,0,2,2
tehz,17.7293796592,3.38800202176,2,8,10
frogge,17.7291978431,5.91314686953,0,2,2
rillocks,17.7259389852,5.42257415527,0,4,4
lyra,17.7169791984,5.83695204257,0,2,2
jackmehoff,17.7166145056,5.86450347919,0,2,2
charlie,17.7006913652,6.02158775086,0,2,2
sabe,17.6939516667,3.21453998841,1,7,8
jello,17.6807150423,3.25967466923,2,11,13
soapymario,17.6713147875,3.28442055013,3,6,9
liam_butler,17.6673384456,6.26628461383,0,2,2
matt47,17.6673384456,6.26628461383,0,2,2
colt,17.6613529856,6.33021997137,0,2,2
 ô·¥è·¥Ö·¥Ä·¥Ñ…™·¥è·¥ús,17.6562073261,3.89648155772,1,6,7
jollie,17.6271471178,1.69038995243,11,34,45
general1712,17.6251596911,5.48535296578,0,4,4
maxi,17.6227902384,6.22931743478,0,2,2
whitegrizzly,17.6211632096,6.0044317998,0,2,2
pigwick,17.6145656845,5.7986697379,0,2,2
scootieloo,17.6025155386,5.99030365635,0,2,2
chibaco,17.5839681544,2.74079159886,4,14,18
the drew,17.5679362572,2.44397081029,4,16,20
bozz,17.559839839,6.18922189329,0,2,2
leet,17.5485033739,4.21970280349,1,6,7
blank,17.5269841039,5.98245346039,0,2,2
cochran,17.5152842159,4.62876505732,1,5,6
coolguy76,17.5097639482,3.40274370251,2,6,8
rodan,17.5087484509,5.80398202432,0,2,2
gambit,17.4724485757,6.03130753421,0,2,2
maestro,17.4665216506,6.23929361131,0,2,2
chinstrap,17.4649334833,4.56998857617,1,4,5
mechanicalmarine,17.4535034222,6.30713173229,0,2,2
catlover321,17.4273629095,4.24425822915,1,4,5
scraggus,17.4207899857,6.18548881364,0,2,2
ponkapa,17.4030441628,4.13217990798,1,8,9
juan doe,17.387512858,6.29179480407,0,2,2
capsui,17.3777696809,4.18759727911,1,7,8
hollow,17.3321861393,5.18723048733,0,3,3
jonnjonn,17.3164688707,1.60495735663,11,37,48
beets,17.3124066278,5.63406210559,0,2,2
sad,17.3097710331,6.27674314988,0,2,2
spammalanche,17.3002319546,5.77018147601,0,2,2
harmless,17.2905728248,6.22322606387,0,2,2
mikeyg,17.2894835768,5.66175718426,0,2,2
cracker jones,17.2842226553,1.44766496589,15,47,62
highlyeducational,17.2602278329,6.07035824737,0,2,2
cennis91,17.2536829322,3.5972691582,1,11,12
spell,17.2327577155,3.42342737229,2,7,9
louieg,17.2309667725,5.92776788088,0,2,2
luka,17.1959174057,3.67739218784,2,6,8
caprigon,17.1913245938,5.86071904972,0,4,4
iamlazee,17.1861337018,5.94449519045,0,2,2
lv20ninja,17.1802136466,3.22931746815,3,7,10
ohhhbreezy,17.1645697169,4.37309275394,1,4,5
holosly,17.1573329149,6.26923433457,0,2,2
ppdmd,17.1573329149,6.26923433457,0,2,2
superflopp,17.1366423766,2.65270476743,3,9,12
master j.j.,17.1358355436,6.24039459921,0,2,2
beech,17.1282962852,3.35401483022,1,12,13
jgly,17.1215650399,4.2410114631,1,4,5
kraken,17.1082289074,6.27707797796,0,1,1
starcutter,17.1011463592,6.0665411989,0,2,2
driftintheabyss,17.1009098272,6.2415552758,0,2,2
amaya,17.0988004859,6.241919664,0,2,2
dinner,17.0933637711,6.08039702859,0,3,3
eltrion,17.0678247458,5.90984228943,0,2,2
sam,17.0659865662,5.90317544352,0,2,2
mr_sharpie93,17.0643868798,6.22653035915,0,2,2
zarfon,17.0353081779,6.09705358847,0,2,2
ravioli,17.0284430048,6.30597887962,0,2,2
fj20,17.0087845428,2.1962828392,7,15,22
black rob,16.9946507075,6.21682728317,0,2,2
drlight,16.9870335546,5.93536565379,0,2,2
myroknpancakes,16.9832741884,3.3371002146,2,8,10
sunkin,16.9699023353,2.79304932376,3,9,12
kastakatter,16.9651663509,5.6511482112,0,4,4
sianvar,16.9633447285,6.49717448643,0,1,1
giggitoxin,16.9572689606,6.19807969429,0,2,2
qk shkz,16.9273178368,6.23983584333,0,2,2
zombieheart84,16.9273178368,6.23983584333,0,2,2
abc,16.9273178368,6.23983584333,0,2,2
umi,16.9273178368,6.23983584333,0,2,2
dd,16.9273178368,6.23983584333,0,2,2
raxcity,16.9273178368,6.23983584333,0,2,2
aubfox,16.9273178368,6.23983584333,0,2,2
deku,16.9273178368,6.23983584333,0,2,2
draxsel,16.9273178368,6.23983584333,0,2,2
red,16.9273178368,6.23983584333,0,2,2
riseup93,16.9273178368,6.23983584333,0,2,2
grraffe,16.9273178368,6.23983584333,0,2,2
uh what,16.9273178368,6.23983584333,0,2,2
heisenberg,16.9273178368,6.23983584333,0,2,2
waffles,16.9273178368,6.23983584333,0,2,2
muthaluva777,16.9273178368,6.23983584333,0,2,2
beekle,16.9273178368,6.23983584333,0,2,2
miles,16.9273178368,6.23983584333,0,2,2
jazz,16.9273178368,6.23983584333,0,2,2
j,16.9273178368,6.23983584333,0,2,2
theycallmechris,16.9273178368,6.23983584333,0,2,2
paper tiger,16.9273178368,6.23983584333,0,2,2
azzy,16.9273178368,6.23983584333,0,2,2
searcher,16.9273178368,6.23983584333,0,2,2
edwin...,16.9273178368,6.23983584333,0,2,2
sambook,16.9273178368,6.23983584333,0,2,2
tuna,16.9273178368,6.23983584333,0,2,2
sunshine,16.9273178368,6.23983584333,0,2,2
15(ichigo),16.9273178368,6.23983584333,0,2,2
irish,16.9273178368,6.23983584333,0,2,2
shadow light master,16.9273178368,6.23983584333,0,2,2
dinkleberg,16.9273178368,6.23983584333,0,2,2
yuxminato,16.9273178368,6.23983584333,0,2,2
rickter_scale,16.9273178368,6.23983584333,0,2,2
themickeynick,16.9273178368,6.23983584333,0,2,2
sfgman,16.9273178368,6.23983584333,0,2,2
gaymer,16.9273178368,6.23983584333,0,2,2
d-tek,16.9273178368,6.23983584333,0,2,2
zurdo,16.9273178368,6.23983584333,0,2,2
mookie,16.9148029711,6.1975946788,0,2,2
bearrimshot,16.8858259493,5.10350164663,0,3,3
jojohnson,16.8847446083,5.91443560749,0,2,2
vidya_james,16.8630586347,3.08798756036,3,8,11
halqery,16.8408465889,5.31485467737,0,4,4
krutchby,16.8366823264,6.18674458762,0,2,2
shyguyking,16.8278588736,5.63034924809,0,2,2
comb,16.8236462299,3.5278074541,2,7,9
bunnyblast,16.8164815237,6.1927063121,0,2,2
rocktimus crime,16.8125235518,2.34507455643,3,18,21
kohenbro,16.8078355606,5.51238629639,0,4,4
castaway,16.8048785331,6.06752345676,0,2,2
babycakes,16.7926633337,3.37648196326,2,6,8
m2cain,16.7880607121,6.19335774512,0,2,2
superduperfanofboom,16.7666227916,6.17256403512,0,2,2
vex kasrani,16.7656066056,3.47145457299,2,9,11
joebro,16.7640158072,2.73705125559,3,10,13
robslabgod,16.7588108091,5.72440338838,0,2,2
keychain,16.7291459219,3.82896436865,2,4,6
saltking,16.7179026363,5.18974185004,0,4,4
jerzilla,16.6612408912,6.01798349036,0,2,2
rockmix,16.640668669,5.94271993402,0,2,2
rollock,16.6300312908,5.42999061067,0,3,3
killer,16.6285571143,4.84331459271,0,5,5
kintsukuroi,16.6174867671,2.95374274647,3,8,11
jungle,16.6116018415,4.8159266935,0,7,7
silentknight,16.6100905419,4.36393559366,1,6,7
falker,16.6088068777,3.31314738797,3,7,10
scott,16.5972710002,6.15290821858,0,2,2
chibama,16.5810716352,4.23836028601,1,4,5
diet clorox,16.556246957,2.96097859686,3,7,10
jpeghero,16.5542790113,5.72001128222,0,3,3
atari,16.5322571135,2.46838690198,5,15,20
instacover,16.5173598147,6.03304199256,0,2,2
ejmp,16.4962755282,6.14526597827,0,1,1
dmolz,16.4943829733,4.97088513919,0,4,4
lunarnova,16.4770164007,2.03418094236,6,32,38
curiousplaces,16.4686400239,5.98022918707,0,2,2
jedipanda,16.4659275172,4.78548832619,0,5,5
madara,16.441934774,5.23549851259,0,4,4
thelorax,16.4190514074,4.04640279458,1,6,7
hotsauce,16.4103163952,2.89984023575,3,8,11
bogmyer,16.4083638818,5.8813774986,0,3,3
beastly bad,16.3983321374,2.96542294799,2,8,10
mattatari,16.3818816821,4.37046741309,1,5,6
pc jeff,16.3765259588,5.97535171364,0,3,3
nnaughtydogg,16.3475604048,5.11964984774,0,4,4
sugaaku,16.3364493551,1.86506395425,9,22,31
magfmur,16.3354417012,5.811464978,0,2,2
duma,16.3219024556,3.63372830284,1,8,9
nuggz,16.2852093148,3.61133172791,2,10,12
recneps,16.2601316871,4.30110904401,1,6,7
unknown presence,16.214151524,3.20460984708,2,7,9
dr gibs,16.2021899007,5.23131951349,0,4,4
wilbur,16.1675007027,3.40600352588,2,6,8
thegoat,16.1110336081,6.0577218926,0,2,2
i do stuff,16.0800575843,3.5226688503,2,5,7
bill,16.079757591,3.88180181538,1,6,7
lord horatio,16.0571413756,5.55786234878,0,4,4
i use tap jump,16.0361094318,3.71890763291,1,6,7
scruffy mcwonder crumpet,16.0309748518,3.29341028199,3,7,10
jedisalazar,16.0197253748,5.71544602071,0,2,2
feathersruffled,16.0048033259,3.62416651573,2,4,6
bennypuff,15.9508514505,3.52900909465,2,7,9
elitescoringguy,15.9214963186,2.56414339609,3,14,17
mrkymrk,15.9033268205,4.79295813394,0,5,5
redwolf,15.8831330222,5.97846405882,0,2,2
sireddie,15.8779664947,3.36262852305,2,7,9
noelkitten,15.8731837029,5.6545362116,0,2,2
eclipse,15.865224706,5.17605600751,0,4,4
12ties,15.8578722911,3.48237531787,1,5,6
lampyshade,15.8183628574,5.42116147248,0,4,4
thedarkdreamer,15.802391653,6.01484204148,0,2,2
codytappen,15.7876556918,5.60934347854,0,2,2
tilt,15.7816616701,5.21134963521,0,4,4
jackkenney,15.760878246,5.6493277774,0,2,2
mixtape,15.752776957,3.48065539881,2,5,7
swiftzx,15.7513228316,3.75188931787,1,6,7
blahguy,15.7454563257,5.81008494948,0,2,2
twunt,15.7420357973,2.91471648066,2,13,15
turquoise,15.7344568221,3.26518439611,2,7,9
lloyd-black,15.7317314375,3.58250112751,1,8,9
don,15.7260269132,3.55845792295,2,5,7
spaz,15.7173495252,4.20030513959,1,4,5
2%gay,15.7131552885,4.07037479325,1,8,9
vondo,15.7009495075,4.71229117812,0,5,5
norwayray,15.6664324444,5.2529796654,0,2,2
dk dredd,15.6475640437,5.91830761396,0,2,2
mm720,15.6456035156,5.58317595347,0,4,4
yolft,15.615209065,2.4089900405,2,21,23
crug,15.584857303,5.84565477559,0,3,3
uncle onion,15.5522960143,5.93876560258,0,2,2
kobra,15.5414512328,3.13958037756,2,11,13
atlas,15.529487589,2.33397946564,5,17,22
katiebug (sfk),15.5257668944,5.60340187496,0,2,2
aedrenaline,15.5125143786,5.74469940782,0,3,3
valyrym,15.4989919779,5.72015962435,0,3,3
banana,15.4989919779,5.72015962435,0,3,3
tydye,15.4962095478,5.71435404844,0,2,2
bennyboy98,15.4862446417,5.96174045904,0,2,2
swankeaboo,15.4652626784,4.83779188009,0,6,6
fmaj7,15.3989972977,3.88227781637,1,6,7
shimshamlando,15.3948294331,2.30496420877,4,28,32
t-bone,15.3776656819,3.41406562041,2,6,8
mzadeh,15.3403233553,5.22570020611,0,4,4
peacemaker,15.2959963826,4.39461435569,0,6,6
crestfallen,15.2479338985,2.93250771359,3,7,10
tanuki,15.2414745664,5.77050178339,0,2,2
tron,15.2082210298,5.60720474312,0,4,4
8oz,15.2060409532,3.92748675446,1,4,5
zbomber,15.205404623,4.9833023318,0,4,4
mariokartmoney,15.2023991933,5.46979181665,0,4,4
godspeed,15.1920565176,4.07837800859,1,7,8
kezzup,15.1441032557,3.63048679538,1,8,9
bagel,15.1356957542,5.1963265951,0,4,4
dude wut,15.1302443839,4.51037891695,1,4,5
thisisgettingold,15.115537955,5.93072884891,0,2,2
lvl99wizard,15.0849436663,4.82104494233,0,4,4
wiseacre,15.0522068012,3.59789365081,1,11,12
warhorse,15.0486896386,3.76756748685,1,6,7
bung0o,15.0459137884,5.20225435693,0,4,4
t,15.0292084782,3.14997787532,2,7,9
dyo,14.9977642507,3.54290952947,2,6,8
dr-wumbo,14.9837672845,5.50489331454,0,2,2
ceephax,14.8596570391,5.78951951926,0,2,2
rumi1819,14.8561463784,5.24197656925,0,4,4
hufff,14.8528891029,3.63061231029,1,6,7
fig,14.8379883515,5.44294090835,0,4,4
ir,14.8042839546,3.89579082211,1,6,7
adulix,14.7935449934,4.99541774313,0,5,5
bchill,14.7340712639,3.21503938667,2,7,9
meccs,14.7127268957,5.02285300286,0,5,5
snoosnoo,14.6679473011,4.23936465966,1,4,5
captainpugh,14.6188227988,5.43823578048,0,4,4
cnasty613,14.6121872429,3.46866104851,2,6,8
kevorkian,14.6064815208,2.82681131674,3,13,16
showtime,14.5887556482,5.82356153644,0,2,2
bear,14.5885043092,5.31724290645,0,4,4
feartheday,14.5811624515,2.89367912022,1,18,19
drunkn smash,14.5529900135,4.5068725197,0,5,5
midgetto,14.536314162,2.31332084563,4,18,22
goofinhiemer,14.5222469663,4.98966185034,0,4,4
fmax,14.4895155373,5.50407742618,0,4,4
marfthekid,14.4838574609,5.52958296959,0,4,4
willie,14.449067642,3.76736097264,1,7,8
petty page,14.4135405908,3.26461929688,1,7,8
burmu,14.4082298553,5.35420278311,0,4,4
hiddenmi$t,14.3797253748,4.93837031307,0,4,4
ferguz,14.3535040248,4.93195158999,0,6,6
apimpnamedslickback,14.3494989649,2.89604794271,2,9,11
cag,14.3427522882,5.13575468617,0,4,4
armadillo,14.3382913891,4.55803170049,0,6,6
ngwn,14.334738089,3.40078233547,1,9,10
sevshun,14.3066640669,3.4073934989,1,9,10
dennysgrandslambreakfast,14.2817644011,5.15765548501,0,4,4
yaks,14.2668147014,3.67727051245,1,8,9
ryden hope,14.2664534487,5.69617772613,0,2,2
rhubarb,14.2337738636,2.4028955104,3,18,21
usvn,14.2285540027,3.37481982628,1,11,12
jp3,14.2256006374,2.91509828479,2,6,8
spaghetti,14.2182139655,3.02050155123,1,11,12
auggie,14.2087710145,4.08568934734,0,9,9
cgmontage,14.1818107051,4.15770283416,0,7,7
spazer,14.1111257644,3.1084771515,2,8,10
primefry,14.0872175835,3.06845922686,1,11,12
chacalaca88,14.0592887048,4.51171095119,0,6,6
y-tho,14.0394999085,4.89337778716,0,4,4
adam duncan,14.0138043627,3.30202766827,2,6,8
godofgrunts,13.9874401142,4.75569824959,0,7,7
burglor,13.9872891528,5.36870827097,0,4,4
noro,13.9311355664,3.01811191047,2,8,10
hiv+,13.9018269926,3.40182871909,1,8,9
myk,13.8626267077,5.36647171848,0,4,4
edgar allen pwn,13.8498416915,3.61761893978,1,10,11
telemonic,13.8348456449,5.10663550475,0,4,4
adamant,13.8244907836,5.26140974939,0,4,4
turtle,13.8129463219,4.39861893127,0,8,8
road-rage 64,13.7970044412,4.50238702391,0,6,6
bort,13.7774909239,4.06909894996,0,6,6
mf space,13.7084587926,4.73300019529,0,5,5
frapple_apple,13.7082693246,3.50582661995,1,7,8
rich,13.7007553579,4.9421460901,0,5,5
kronk!,13.6464207581,2.63696435187,2,18,20
nox,13.623814551,3.01139765968,2,8,10
vnko,13.6217316421,3.97511390083,1,4,5
scruff,13.6047050211,4.9783980664,0,6,6
bluey,13.5967112435,3.04511547102,2,10,12
lotionhole,13.5949478641,4.41556199518,0,6,6
mike4real,13.5935756712,3.33682495087,2,10,12
mattc,13.5549974111,4.32459556879,0,5,5
cat,13.5100554597,4.71980783012,0,5,5
whiz kid,13.41632192,5.16801688047,0,4,4
blanco mano,13.4015177081,4.59893174621,0,5,5
heavy,13.3926120123,4.16217097566,0,5,5
ben,13.3820151555,2.55313495704,2,16,18
scaryman,13.3668329574,4.32703399476,0,6,6
neff,13.2865074669,5.55475005027,0,3,3
woof,13.2208606529,5.01298816141,0,5,5
mop,13.2027815864,3.28180002676,1,8,9
dabs?,13.1728637698,4.09408740709,0,9,9
fitzy,13.1657983564,4.52578026489,0,4,4
hwatts,13.1336418585,3.65744503068,0,13,13
gato,13.0901308656,4.41738383503,0,5,5
majinchu,13.0416499613,5.03698040225,0,4,4
sour,13.0156446877,3.75426160617,0,10,10
greatwhitebuffalo,13.0021819289,4.66161051588,0,3,3
oldiz,12.9634733817,5.08418225991,0,4,4
whitezebra,12.951248327,2.72641822897,2,17,19
brother quang,12.9065844232,3.33739454305,2,8,10
weslec,12.8990413114,3.74933141774,0,8,8
mormonjo,12.8650970917,4.56480295874,0,4,4
zorro253,12.8601877009,3.24711843735,1,10,11
hashi,12.8488087953,2.42404066274,3,22,25
monica,12.8102829405,4.5799332374,0,5,5
nardwell,12.7836791898,1.88523008129,6,45,51
boogie!,12.7715666219,3.01420642058,1,14,15
phynque,12.7053531917,3.42772796394,0,12,12
rokd,12.6929834792,4.62639676455,0,4,4
twisty,12.6730362555,2.58074250795,2,27,29
lotus,12.6565234176,5.4526772285,0,2,2
jimbot,12.5261010076,4.50079562529,0,7,7
jofis,12.5244683231,3.57943952737,1,7,8
gasmask,12.432596719,3.91514739088,0,8,8
neph_girl,12.4099955261,2.95248072025,1,14,15
dexter,12.3277391112,4.05285347274,0,10,10
fabulousboy,12.3095847926,3.83563857941,0,9,9
tyler_stewart8,12.3034377592,3.60380016585,1,6,7
terrible fate,12.2566983961,3.51180131019,1,12,13
putpasswordhere,12.2385723394,4.50306841539,0,8,8
ohb-noa,12.1181073699,4.13821442803,0,8,8
lolitaz667,12.0492864773,3.33061352847,1,8,9
syph,11.9415362577,3.64434675576,0,9,9
moog,11.8679314828,3.12400362672,1,8,9
reject,11.8213796409,1.99082334085,3,42,45
b rod,11.8005733254,5.01593847821,0,5,5
jame,11.7171166737,3.36800476833,1,10,11
doublej,11.7154130485,3.56738159477,0,13,13
little things,11.7000604539,4.00926022113,0,7,7
nicklebackair,11.6380369816,3.5076390662,0,9,9
ufo,11.616368282,4.13824321395,0,7,7
altrusan,11.4630431512,3.1092123357,1,10,11
microwaved hotdogs,11.4336936147,4.10903044853,0,10,10
half man,11.4287838487,3.67478661086,0,8,8
t3rquoise,11.3123747726,3.83187299535,0,10,10
sven,11.2952469196,2.64658463821,2,14,16
thundergarms,11.2508987343,3.29944474074,1,7,8
ranger,11.2432943957,4.0748158276,0,10,10
mello,11.0912089954,3.19857469468,1,16,17
qwesseccssffdy,10.9559601879,4.94094153375,0,4,4
stevenballoons,10.8895417739,3.1428184804,1,9,10
mambo,10.8114132321,4.7180716102,0,4,4
fireblaster-2,10.7772287341,4.28081047735,0,4,4
jerry bean,10.7657802064,5.18257659913,0,2,2
baedough07,10.7116111756,4.11341319001,0,5,5
2p,10.5378975181,3.31729188427,0,16,16
knothy,10.5176161114,3.62953910582,0,12,12
taco truck,10.4574100987,3.40959423853,0,9,9
ceec,10.4168152966,3.4016264153,1,10,11
brizzles,10.229046821,4.00431413544,0,8,8
copper,10.1891017894,3.74925723205,0,8,8
lloyd.,10.1877227895,3.63995997324,0,9,9
